Siim_Kallas	isMarriedTo	Joaquín_Almunia
Albert_II_of_Germany	hasChild	Frederick_III,_Holy_Roman_Emperor
Leopold_III,_Margrave_of_Austria	isMarriedTo	Agnes_of_Germany
Josephine_of_Leuchtenberg	isMarriedTo	Oscar_I_of_Sweden
Henry_VII,_Holy_Roman_Emperor	hasChild	John_of_Bohemia
Louis_XIV_of_France	isMarriedTo	Maria_Theresa_of_Spain
Prince_Bernhard_of_the_Netherlands	hasChild	Prince_Claus_of_the_Netherlands
Paul_I_of_Russia	isMarriedTo	Maria_Feodorovna_(Sophie_Dorothea_of_Württemberg)
Ptolemy_VIII_Physcon	isMarriedTo	Cleopatra_II_of_Egypt
Diane_Cilento	isMarriedTo	Sean_Connery
Wilhelmina_of_the_Netherlands	hasChild	Juliana_of_the_Netherlands
Ferdinand_I_of_Romania	hasChild	Michael_I_of_Romania
Queen_Paola_of_Belgium	hasChild	Philippe_of_Belgium
Amélie_of_Orléans	isMarriedTo	Carlos_I_of_Portugal
Malcolm_III_of_Scotland	hasChild	David_I_of_Scotland
Louis,_Dauphin_of_France_(1729–1765)	hasChild	Louis_XVI_of_France
Augusta_of_Saxe-Weimar-Eisenach	hasChild	Princess_Louise_of_Prussia
Adèle_of_Champagne	hasChild	Isabelle_of_Hainaut
Joan_of_France,_Duchess_of_Brittany	hasChild	Francis_I,_Duke_of_Brittany
Louis_XIV_of_France	hasChild	Louis,_Dauphin_of_France,_Duke_of_Burgundy
Margravine_Friederike_of_Brandenburg-Schwedt	isMarriedTo	Frederick_II_Eugene,_Duke_of_Württemberg
Wilhelm_II,_German_Emperor	hasChild	Prince_Joachim_of_Prussia
Marie_of_Champagne	isMarriedTo	Baldwin_I_of_Constantinople
Diane_Ladd	hasChild	Laura_Dern
Saint_Louis_IX_of_France	isMarriedTo	Margaret_of_Provence
Hassan_II_of_Morocco	isMarriedTo	Lalla_Latifa
Charles_II,_Archduke_of_Austria	isMarriedTo	Maria_Anna_of_Bavaria_(1551–1608)
Cleopatra_II_of_Egypt	hasChild	Cleopatra_Thea
Ferdinand_III,_Holy_Roman_Emperor	hasChild	Eleanor_of_Austria,_Queen_of_Poland
Charles_II,_Grand_Duke_of_Mecklenburg-Strelitz	hasChild	Frederica_of_Mecklenburg-Strelitz
Yolande_of_Aragon	hasChild	Marie_of_Anjou
Rosalynn_Carter	isMarriedTo	Jimmy_Carter
Lolo_Soetoro	isMarriedTo	Ann_Dunham
Irene_Angelina	hasChild	Maria_of_Swabia
Louis,_Duke_of_Savoy	hasChild	Bona_of_Savoy
Leopold_II,_Holy_Roman_Emperor	hasChild	Archduke_Joseph,_Palatine_of_Hungary
Darryl_F._Zanuck	hasChild	Richard_D._Zanuck
María_Isabella_of_Spain	hasChild	Maria_Christina_of_the_Two_Sicilies
Louis,_Grand_Dauphin	hasChild	Louis,_Dauphin_of_France,_Duke_of_Burgundy
Margaret_of_Bavaria	isMarriedTo	John_the_Fearless
Raynald_of_Châtillon	hasChild	Agnes_of_Antioch
Philip_III_of_France	isMarriedTo	Marie_of_Brabant,_Queen_of_France
Elisabetta_Farnese	hasChild	Maria_Antonia_Ferdinanda_of_Spain
Grand_Duke_Michael_Nikolaevich_of_Russia	hasChild	Grand_Duke_Alexander_Mikhailovich_of_Russia
Joséphine_de_Beauharnais	isMarriedTo	Napoleon
Leopoldo_Calvo-Sotelo	hasChild	Felipe_González
Ferdinand_II_of_Aragon	hasChild	Philip_I_of_Castile
Frederick_William_III_of_Prussia	isMarriedTo	Louise_of_Mecklenburg-Strelitz
Margherita_of_Savoy	hasChild	Victor_Emmanuel_III_of_Italy
Frederick_I_of_Sweden	isMarriedTo	Ulrika_Eleonora,_Queen_of_Sweden
Maria_Theresa_of_Austria_(1816–1867)	hasChild	Princess_Maria_Annunciata_of_Bourbon-Two_Sicilies
Empress_Kōjun	hasChild	Akihito
Oona_O'Neill	isMarriedTo	Charlie_Chaplin
Catherine_de'_Medici	hasChild	Claude_of_Valois
Maria_Feodorovna_(Dagmar_of_Denmark)	hasChild	Nicholas_II_of_Russia
Landgravine_Elisabeth_Amalie_of_Hesse-Darmstadt	hasChild	Johann_Wilhelm,_Elector_Palatine
Maria_Luisa_of_Savoy	hasChild	Ferdinand_VI_of_Spain
Leopold_III,_Margrave_of_Austria	hasChild	Agnes_of_Babenberg
Charles_II_of_Naples	isMarriedTo	Mary_of_Hungary,_Queen_of_Naples
Bona_Sforza	hasChild	Anna_Jagiellon
Thomas,_Count_of_Savoy	hasChild	Beatrice_of_Savoy
Sophia_of_Prussia	hasChild	Paul_of_Greece
Princess_Louise_of_Orléans	hasChild	Princess_María_de_las_Mercedes_of_Bourbon-Two_Sicilies
Stephen_of_England	isMarriedTo	Matilda_of_Boulogne
Adela_of_France,_Countess_of_Flanders	hasChild	Matilda_of_Flanders
Lyndon_B._Johnson	isMarriedTo	Lady_Bird_Johnson
Rozala_of_Italy	isMarriedTo	Robert_II_of_France
Mark_Antony	hasChild	Cleopatra_Selene_II
Maggie_Smith	hasChild	Toby_Stephens
Sophie_Amalie_of_Brunswick-Lüneburg	hasChild	Prince_George_of_Denmark
Betty_Ford	isMarriedTo	Gerald_Ford
Isabella_of_Angoulême	hasChild	Eleanor_of_Provence
Conrad_II,_Holy_Roman_Emperor	isMarriedTo	Gisela_of_Swabia
Charles_II_of_Naples	hasChild	Blanche_of_Anjou
Abraham_Lincoln	hasChild	Robert_Todd_Lincoln
John_VI_of_Portugal	hasChild	Miguel_I_of_Portugal
Nargis	isMarriedTo	Sunil_Dutt
Desi_Arnaz	isMarriedTo	Lucille_Ball
Princess_Ingeborg_of_Denmark	hasChild	Princess_Märtha_of_Sweden
Philip_the_Good	isMarriedTo	Isabella_of_Portugal,_Duchess_of_Burgundy
Abby_Aldrich_Rockefeller	hasChild	David_Rockefeller
Princess_Henrietta_of_Nassau-Weilburg	hasChild	Archduke_Karl_Ferdinand_of_Austria
Eleonora_Gonzaga_(1630–1686)	hasChild	Eleanor_of_Austria,_Queen_of_Poland
Wilhelm_II_of_Germany	hasChild	Princess_Victoria_Louise_of_Prussia
Tiberius	hasChild	Caligula
Anne_of_Austria	hasChild	Marie_Thérèse_of_Austria
Charles_VI_of_France	hasChild	Joan_of_France,_Duchess_of_Brittany
Henry_II_of_France	hasChild	Charles_IX_of_France
Leopold_III_of_Belgium	hasChild	Albert_II_of_Belgium
Therese_of_Saxe-Hildburghausen	hasChild	Otto,_King_of_Greece
Tony_Blair	isMarriedTo	Cherie_Blair
Wu_Zetian	hasChild	Emperor_Zhongzong_of_Tang
Joanna_Moore	hasChild	Tatum_O'Neal
Thomas,_Count_of_Flanders	hasChild	Amadeus_V,_Count_of_Savoy
Caroline_of_Ansbach	hasChild	Charlotte_of_Mecklenburg-Strelitz
Elizabeth_Cromwell	hasChild	Richard_Cromwell
Jennifer_Jones	isMarriedTo	Robert_Walker_(actor)
Randhir_Kapoor	hasChild	Kareena_Kapoor_Khan
Agnes_of_Merania	hasChild	Philip_I,_Count_of_Boulogne
Miguel_I_of_Portugal	isMarriedTo	Adelaide_of_Löwenstein-Wertheim-Rosenberg
Jobst_of_Moravia	isMarriedTo	Mary,_Queen_of_Hungary
Victoria_Eugenie_of_Battenberg	hasChild	Queen_Sofía_of_Spain
Ingrid_Bergman	hasChild	Isabella_Rossellini
Stephen_of_England	hasChild	Henry_II_of_England
Germaine_of_Foix	hasChild	Isabella_of_Portugal
Joséphine_de_Beauharnais	hasChild	Marie_Louise,_Duchess_of_Parma
Baldwin_V,_Count_of_Hainaut	hasChild	Baldwin_I_of_Constantinople
Jobst_of_Moravia	hasChild	Sigismund,_Holy_Roman_Emperor
Isabella_of_Angoulême	isMarriedTo	John_of_England
Louise_of_Hesse-Kassel	hasChild	Alexandra_of_Denmark
Elisabetta_Farnese	hasChild	Louise_Élisabeth_d'Orléans
Princess_Joséphine_Charlotte_of_Belgium	hasChild	Henri,_Grand_Duke_of_Luxembourg
Francisco_da_Costa_Gomes	isMarriedTo	José_Baptista_Pinheiro_de_Azevedo
Irene_Angelina	hasChild	Kunigunde_of_Hohenstaufen
Isabeau_of_Bavaria	hasChild	Catherine_of_Valois
Charles_Emmanuel_I,_Duke_of_Savoy	hasChild	Victor_Amadeus_I,_Duke_of_Savoy
Zulfikar_Ali_Bhutto	isMarriedTo	Nusrat_Bhutto
Amalie_Auguste_of_Bavaria	isMarriedTo	John_of_Saxony
Jimmy_Carter	isMarriedTo	Rosalynn_Carter
Constance_of_Hungary	isMarriedTo	Ottokar_I_of_Bohemia
Francis_II,_Holy_Roman_Emperor	isMarriedTo	Caroline_Augusta_of_Bavaria
Joseph_P._Kennedy,_Sr.	hasChild	Ted_Kennedy
Joan_of_Navarre,_Queen_of_England	isMarriedTo	Henry_IV_of_England
Albert_I_of_Germany	hasChild	Frederick_the_Fair
Philip_I,_Duke_of_Burgundy	hasChild	Philip_the_Bold
Maximilian_I,_Holy_Roman_Emperor	isMarriedTo	Anne_of_Brittany
Bianca_Maria_Sforza	isMarriedTo	Maximilian_I,_Holy_Roman_Emperor
Charles_VI_of_France	hasChild	Charles_VII_of_France
Catherine_of_Medici	hasChild	Mary,_Queen_of_Scots
Isabella_of_Portugal	hasChild	Maria_of_Austria,_Holy_Roman_Empress
Henry_II_of_France	hasChild	Henry_III_of_France
Hema_Malini	isMarriedTo	Dharmendra
Joaquín_Almunia	isMarriedTo	Siim_Kallas
Bertrade_de_Montfort	isMarriedTo	Philip_I_of_France
Henry_VIII_of_England	hasChild	Elizabeth_I_of_England
Wenceslaus_II_of_Bohemia	hasChild	Elizabeth_of_Bohemia_(1292–1330)
Christian_I_of_Denmark	hasChild	John,_King_of_Denmark
Maria_Beatrice_d'Este,_Duchess_of_Massa	hasChild	Maria_Theresa_of_Austria-Este,_Queen_of_Sardinia
Shah_Jahan	isMarriedTo	Mumtaz_Mahal
Antoine_of_Navarre	hasChild	Marie_de'_Medici
Joan_the_Lame	hasChild	John_II_of_France
John_Cromwell_(director)	hasChild	James_Cromwell
Anna_Pavlovna_of_Russia	isMarriedTo	William_II_of_the_Netherlands
Fernando_II_of_Portugal	isMarriedTo	Maria_II_of_Portugal
Emperor_Gaozong_of_Tang	hasChild	Emperor_Zhongzong_of_Tang
Blanche_of_Castile	hasChild	Saint_Louis_IX_of_France
Jack_Cassidy	isMarriedTo	Shirley_Jones
Henry_VII,_Holy_Roman_Emperor	hasChild	Louis_IV,_Holy_Roman_Emperor
Alexandra_Feodorovna_(Charlotte_of_Prussia)	hasChild	Alexander_II_of_Russia
Countess_Augusta_Reuss_of_Ebersdorf	hasChild	Leopold_I_of_Belgium
John_V_of_Portugal	hasChild	Peter_III_of_Portugal
Jacqueline_Kennedy_Onassis	hasChild	Lady_Bird_Johnson
Agnes_of_Poitou	hasChild	Bertha_of_Savoy
George_C._Scott	isMarriedTo	Colleen_Dewhurst
Charlotte_of_Mecklenburg-Strelitz	hasChild	Caroline_of_Brunswick
Oscar_I_of_Sweden	hasChild	Oscar_II_of_Sweden
Princess_María_de_las_Mercedes_of_Bourbon-Two_Sicilies	isMarriedTo	Infante_Juan,_Count_of_Barcelona
Catherine_the_Great	isMarriedTo	Peter_III_of_Russia
Blanche_of_Valois	hasChild	Catherine_of_Bohemia
Constantine_the_Great	hasChild	Licinius
Dorothea_of_Brandenburg	hasChild	John,_King_of_Denmark
Dimple_Kapadia	isMarriedTo	Rajesh_Khanna
Charles_II,_Duke_of_Parma	hasChild	Elisa_Bonaparte
Prince_Philippe,_Count_of_Paris	hasChild	Princess_Louise_of_Orléans
José_Pedro_Pérez-Llorca	hasChild	Rafael_Arias-Salgado
Anne_of_Austria,_Queen_of_Poland	isMarriedTo	Sigismund_III_Vasa
Prince_Bernhard_of_the_Netherlands	isMarriedTo	Juliana_of_the_Netherlands
Maria_Christina_of_Austria	hasChild	Alfonso_XIII_of_Spain
Maria_I_of_Portugal	isMarriedTo	Peter_III_of_Portugal
Salim_Khan	hasChild	Arbaaz_Khan_(Indian_actor)
Theresa_of_Portugal,_Countess_of_Flanders	isMarriedTo	Odo_III,_Duke_of_Burgundy
George_VI_of_the_United_Kingdom	hasChild	Elizabeth_II
Ferdinand_VII_of_Spain	hasChild	Joseph_Bonaparte
Archduchess_Elisabeth_Franziska_of_Austria	hasChild	Archduke_Eugen_of_Austria
Kamehameha_I	isMarriedTo	Kaʻahumanu
Matilda_of_Boulogne	isMarriedTo	Stephen_of_England
Beatrix_of_the_Netherlands	isMarriedTo	Prince_Claus_of_the_Netherlands
Frederick_V,_Elector_Palatine	hasChild	Sophia_of_Hanover
Oskar_Lafontaine	hasChild	Gerhard_Schröder
Princess_Marie_Isabelle_of_Orléans	hasChild	Princess_Isabelle_of_Orléans_(1878–1961)
Sibylla_of_Anjou	isMarriedTo	Thierry,_Count_of_Flanders
John_IV_of_Portugal	isMarriedTo	Luisa_de_Guzmán
Ernest_I,_Duke_of_Saxe-Gotha	isMarriedTo	Princess_Elisabeth_Sophie_of_Saxe-Altenburg
Winston_Churchill	hasChild	Sarah_Churchill_(actress)
Pedro_II_of_Brazil	hasChild	Isabel,_Princess_Imperial_of_Brazil
Eleanor_of_Aquitaine	hasChild	Richard_I_of_England
Pythodorida_of_Pontus	isMarriedTo	Archelaus_of_Cappadocia
Dulce_of_Aragon	hasChild	Berengaria_of_Portugal
Princess_Mary_Adelaide_of_Cambridge	isMarriedTo	Francis,_Duke_of_Teck
Victor_Amadeus_II_of_Sardinia	hasChild	Charles_Emmanuel_III_of_Sardinia
Afonso_I_of_Portugal	hasChild	Sancho_I_of_Portugal
Claude_of_France	hasChild	Henry_II_of_France
Otto,_King_of_Greece	isMarriedTo	Amalia_of_Oldenburg
Childebert_I	isMarriedTo	Chlothar_I
Philip_I_of_Castile	hasChild	Charles_V,_Holy_Roman_Emperor
Oskar_Lafontaine	hasChild	Gesine_Lötzsch
Frederick_William_III_of_Prussia	hasChild	Prince_Charles_of_Prussia
Maria_Theresa_of_Spain	hasChild	Louis,_Grand_Dauphin
Sigrid_the_Haughty	hasChild	Cnut_the_Great
Joseph_P._Kennedy,_Sr.	hasChild	John_F._Kennedy
Kamehameha_I	hasChild	Kamehameha_III
Francis_II,_Holy_Roman_Emperor	hasChild	Ferdinand_I_of_Austria
John_Quincy_Adams	isMarriedTo	Louisa_Adams
Sirikit	hasChild	Vajiralongkorn
Blanche_I_of_Navarre	hasChild	John_II_of_Aragon
Grand_Duchess_Maria_Pavlovna_of_Russia_(1786–1859)	hasChild	Augusta_of_Saxe-Weimar-Eisenach
Ibn_Saud	hasChild	Sultan_bin_Abdulaziz
Empress_Matilda	hasChild	Henry_II_of_England
Benazir_Bhutto	isMarriedTo	Asif_Ali_Zardari
Henry_I_of_France	hasChild	Philip_I_of_France
Adelaide_of_Austria	isMarriedTo	Victor_Emmanuel_II_of_Savoy
Peter_III_of_Portugal	hasChild	John_VI_of_Portugal
Conrad_II,_Holy_Roman_Emperor	hasChild	Henry_III,_Holy_Roman_Emperor
Frederick_V,_Elector_Palatine	hasChild	Charles_I_Louis,_Elector_Palatine
Frederick_II_Eugene,_Duke_of_Württemberg	hasChild	Maria_Feodorovna_(Sophie_Dorothea_of_Württemberg)
Kaʻahumanu	isMarriedTo	Kamehameha_I
Archelaus_of_Cappadocia	isMarriedTo	Pythodorida_of_Pontus
Maria_Leopoldina_of_Austria	hasChild	Amélie_of_Leuchtenberg
Henrietta_Maria_of_France	hasChild	Alexandra_of_Denmark
Louise_of_Orléans	hasChild	Leopold_II_of_Belgium
Albert_I_of_Belgium	isMarriedTo	Elisabeth_of_Bavaria,_Queen_of_Belgium
Joanna_of_Castile	hasChild	Isabella_of_Portugal
Paul_I_of_Russia	hasChild	Anna_Pavlovna_of_Russia
Victor_Emmanuel_II_of_Italy	hasChild	Maria_Pia_of_Savoy
Livia	isMarriedTo	Augustus
Philip_III_of_France	hasChild	Philip_IV_of_France
Margaret_of_Durazzo	hasChild	Ladislaus_of_Naples
Isabella_of_Valois	isMarriedTo	Charles,_Duke_of_Orléans
Henry_VIII_of_England	hasChild	Mary_I_of_England
Barbara_of_Cilli	isMarriedTo	Sigismund,_Holy_Roman_Emperor
Luisa_de_Guzmán	hasChild	Maria_Francisca_of_Savoy
Albert,_Prince_Consort	hasChild	Princess_Helena_of_the_United_Kingdom
Josephine_of_Leuchtenberg	hasChild	Charles_XV_of_Sweden
Joan_Beaufort,_Queen_of_Scots	isMarriedTo	James_I_of_Scotland
Agnes_of_France,_Duchess_of_Burgundy	isMarriedTo	Robert_II,_Duke_of_Burgundy
Louis_XIV_of_France	isMarriedTo	Marie_Thérèse_of_Austria
Maria_Feodorovna_(Dagmar_of_Denmark)	isMarriedTo	Alexander_III_of_Russia
Ingrid_of_Sweden	isMarriedTo	Frederick_IX_of_Denmark
Blanche_I_of_Navarre	isMarriedTo	Martin_I_of_Sicily
Philip_William,_Elector_Palatine	hasChild	Charles_III_Philip,_Elector_Palatine
James_I_of_Scotland	isMarriedTo	Joan_Beaufort,_Queen_of_Scots
Prince_Carlos_of_Bourbon-Two_Sicilies	isMarriedTo	Princess_Louise_of_Orléans
Ernest_Augustus_I_of_Hanover	isMarriedTo	Frederica_of_Mecklenburg-Strelitz
Louis_XI_of_France	hasChild	Charles_VIII_of_France
Louise_of_the_Netherlands	isMarriedTo	Charles_XV_of_Sweden
John_IV,_Duke_of_Brittany	hasChild	John_of_Gaunt,_1st_Duke_of_Lancaster
Anne_Eleonore_of_Hesse-Darmstadt	hasChild	Sophie_Amalie_of_Brunswick-Lüneburg
Abby_Aldrich_Rockefeller	hasChild	Nelson_Rockefeller
Pedro_I_of_Brazil	isMarriedTo	Amélie_of_Leuchtenberg
Dimple_Kapadia	hasChild	Rinke_Khanna
George,_Duke_of_Brunswick-Lüneburg	isMarriedTo	Anne_Eleonore_of_Hesse-Darmstadt
Christian_I_of_Denmark	hasChild	Charles_VIII_of_Sweden
Anna_of_Austria,_Queen_of_Spain	hasChild	Elisabeth_of_France_(1602–1644)
Joan_the_Lame	hasChild	Joan_of_France,_Duchess_of_Berry
Harald_V_of_Norway	hasChild	Princess_Märtha_Louise_of_Norway
Dorothea_of_Brandenburg	hasChild	Christina_of_Saxony
Amalie_Auguste_of_Bavaria	hasChild	George,_King_of_Saxony
Prince_Bernhard_of_Lippe-Biesterfeld	isMarriedTo	Juliana_of_the_Netherlands
Catherine_de'_Medici	hasChild	Henry_III_of_France
Elisabeth_of_Bavaria	isMarriedTo	Franz_Joseph_I_of_Austria
Joan_I_of_Navarre	hasChild	Philip_V_of_France
Matilda_of_Boulogne	hasChild	William_I,_Count_of_Boulogne
Kalākua_Kaheiheimālie	hasChild	Kekāuluohi
Margaret,_Countess_of_Anjou	hasChild	Philip_VI_of_France
Anne_of_Austria	hasChild	Philippe_I,_Duke_of_Orléans
Marcus_Vipsanius_Agrippa	hasChild	Julia_the_Elder
Will_Smith	isMarriedTo	Jada_Pinkett_Smith
Marie_Leszczyńska	isMarriedTo	Louis_XV_of_France
Agnes_of_Merania	isMarriedTo	Philip_II_of_France
Berenice_I_of_Egypt	hasChild	Ptolemy_II_Philadelphus
Gustaf_V_of_Sweden	hasChild	Olav_V_of_Norway
Christian_III_of_Denmark	hasChild	Frederick_II_of_Denmark
Louis,_Duke_of_Savoy	hasChild	Charlotte_of_Savoy
Louise_of_Orléans	hasChild	Marie_Henriette_of_Austria
Henry_II_of_England	hasChild	Eleanor_of_England,_Queen_of_Castile
Ann_Dunham	isMarriedTo	Lolo_Soetoro
Ferdinand_I_of_Austria	hasChild	Archduke_Franz_Karl_of_Austria
Maximilian_I,_Holy_Roman_Emperor	isMarriedTo	Mary_of_Burgundy
Maria_Pia_of_Savoy	hasChild	Carlos_I_of_Portugal
Francis,_Duke_of_Teck	hasChild	Adolphus_Cambridge,_1st_Marquess_of_Cambridge
Isabella_of_Valois	hasChild	Jean_II,_Duke_of_Alençon
Charles_II_of_Spain	hasChild	Philip_V_of_Spain
Maria_Theresa_of_Austria	isMarriedTo	Francis_I,_Holy_Roman_Emperor
John_Farrow	hasChild	Mia_Farrow
Victor_Emmanuel_I_of_Sardinia	isMarriedTo	Maria_Theresa_of_Austria-Este,_Queen_of_Sardinia
Sigismund,_Holy_Roman_Emperor	hasChild	Frederick_I,_Elector_of_Brandenburg
Antoine_of_Navarre	hasChild	Jeanne_d'Albret
Constance_of_Sicily,_Queen_of_Aragon	hasChild	Elizabeth_of_Aragon
Frederick_VIII_of_Denmark	hasChild	Prince_Harald_of_Denmark
Henry_IV_of_France	hasChild	Charles,_Cardinal_de_Bourbon
Bona_Sforza	isMarriedTo	Sigismund_I_the_Old
Blanche_of_Castile	isMarriedTo	Louis_VIII_of_France
Louis_IX,_Landgrave_of_Hesse-Darmstadt	hasChild	Frederika_Louisa_of_Hesse-Darmstadt
Victor_Emmanuel_II_of_Savoy	hasChild	Umberto_I_of_Italy
Gustaf_VI_Adolf_of_Sweden	hasChild	Prince_Gustaf_Adolf,_Duke_of_Västerbotten
Marie_of_Champagne	hasChild	Margaret_II,_Countess_of_Flanders
Ferdinand_I_of_Aragon	isMarriedTo	Eleanor_of_Alburquerque
Victoria_of_Baden	hasChild	Gustaf_VI_Adolf_of_Sweden
Hedwig_of_Sagan	isMarriedTo	Casimir_III_of_Poland
Henry_VI,_Holy_Roman_Emperor	hasChild	Otto_IV,_Holy_Roman_Emperor
Margaret_of_France,_Queen_of_England	isMarriedTo	Edward_I_of_England
Jane_Seymour	hasChild	Edward_VI_of_England
Archduke_Karl_Ludwig_of_Austria	isMarriedTo	Princess_Maria_Annunciata_of_Bourbon-Two_Sicilies
Isabella_II_of_Spain	isMarriedTo	Francis,_Duke_of_Cádiz
Louis,_Grand_Dauphin	hasChild	Philip_V_of_Spain
Pierre_Curie	hasChild	Irène_Joliot-Curie
Louis_XII_of_France	isMarriedTo	Anne_of_Brittany
Philip_I_of_France	hasChild	Constance_of_France,_Princess_of_Antioch
François_Mitterrand	hasChild	Jacques_Chirac
Joanna_of_Castile	hasChild	Isabella_of_Austria
Isabella_of_Aragon	hasChild	Marie_of_Brabant,_Queen_of_France
Nancy_Reagan	isMarriedTo	Ronald_Reagan
Rudolf_I_of_Germany	isMarriedTo	Gertrude_of_Hohenburg
Abigail_Adams	hasChild	John_Quincy_Adams
Canute	hasChild	Gunhilda_of_Denmark
Elisabeth_of_France_(1602–1644)	hasChild	Mariana_of_Austria
Ferdinand_I_of_Austria	isMarriedTo	Maria_Anna_of_Savoy
Peter_the_Great	hasChild	Alexei_Petrovich,_Tsarevich_of_Russia
Albert,_Prince_Consort	hasChild	Alexandra_of_Denmark
Adelaide_of_Austria	hasChild	Umberto_I_of_Italy
Edward_III_of_England	isMarriedTo	Philippa_of_Hainault
Amitabh_Bachchan	isMarriedTo	Jaya_Bachchan
Bertha_of_Savoy	hasChild	Henry_V,_Holy_Roman_Emperor
Ozzy_Osbourne	isMarriedTo	Sharon_Osbourne
Gertrude_of_Süpplingenburg	isMarriedTo	Henry_X,_Duke_of_Bavaria
Ernest_Augustus,_Duke_of_Brunswick	hasChild	Prince_Ernest_Augustus_of_Hanover_(1914–1987)
Charles_XV_of_Sweden	hasChild	Oscar_II_of_Sweden
Friedrich_III_of_Germany	hasChild	Wilhelm_II_of_Germany
Eleanor_of_England,_Queen_of_Castile	isMarriedTo	Alfonso_VIII_of_Castile
Prince_Philip,_Duke_of_Edinburgh	isMarriedTo	Elizabeth_II
Kamehameha_I	hasChild	Kīnaʻu
Margaret_I,_Countess_of_Flanders	hasChild	Baldwin_I_of_Constantinople
Maria_Josepha_of_Austria	hasChild	Charles_of_Saxony,_Duke_of_Courland
Chulalongkorn	hasChild	Mahidol_Adulyadej
Charles_II,_Archduke_of_Austria	hasChild	Constance_of_Austria
Joan_I,_Countess_of_Auvergne	hasChild	Margaret_III,_Countess_of_Flanders
Joan_Beaufort,_Countess_of_Westmorland	isMarriedTo	Ralph_de_Neville,_1st_Earl_of_Westmorland
Maria_Anna_of_Savoy	hasChild	Elisabeth_of_Bavaria
Manuel_I_of_Portugal	isMarriedTo	Eleanor_of_Austria
Jacquetta_of_Luxembourg	isMarriedTo	John_of_Lancaster,_1st_Duke_of_Bedford
Prince_Carl,_Duke_of_Västergötland	hasChild	Princess_Märtha_of_Sweden
Sigismund_I_the_Old	hasChild	Sigismund_II_Augustus
Babita	hasChild	Kareena_Kapoor_Khan
Eleanor_of_Aquitaine	hasChild	Louis_VII_of_France
Queen_Elizabeth_The_Queen_Mother	hasChild	Princess_Margaret,_Countess_of_Snowdon
Alice_Claypoole_Gwynne	hasChild	Cornelius_Vanderbilt_III
Mary_Todd_Lincoln	isMarriedTo	Abraham_Lincoln
Frederick_William_II_of_Prussia	hasChild	Prince_Wilhelm_of_Prussia_(1783–1851)
Charles_V,_Duke_of_Lorraine	isMarriedTo	Marie_Jeanne_Baptiste_of_Savoy-Nemours
Charles_III,_Duke_of_Lorraine	hasChild	Henry_II,_Duke_of_Lorraine
Charles_VI,_Holy_Roman_Emperor	isMarriedTo	Elisabeth_Christine_of_Brunswick-Wolfenbüttel
Hassa_bint_Ahmed_Al_Sudairi	hasChild	Fahd_of_Saudi_Arabia
Carl_XVI_Gustaf_of_Sweden	hasChild	Prince_Bertil,_Duke_of_Halland
Eugène_de_Beauharnais	isMarriedTo	Princess_Augusta_of_Bavaria
Ján_Figeľ	isMarriedTo	Olli_Rehn
Margravine_Friederike_of_Brandenburg-Schwedt	hasChild	Frederick_I_of_Württemberg
Joaquín_Almunia	hasChild	José_Luis_Rodríguez_Zapatero
Salomea_of_Berg	hasChild	Casimir_II_the_Just
Amadeo_I_of_Spain	hasChild	Prince_Emanuele_Filiberto,_Duke_of_Aosta
Anne_of_Brittany	isMarriedTo	Maximilian_I,_Holy_Roman_Emperor
Mary_of_Teck	hasChild	Queen_Elizabeth_The_Queen_Mother
Maria_Anna_of_Spain	isMarriedTo	Ferdinand_III,_Holy_Roman_Emperor
Ségolène_Royal	isMarriedTo	François_Hollande
Kaʻahumanu	hasChild	Keelikōlani
Charles_II,_Grand_Duke_of_Mecklenburg-Strelitz	isMarriedTo	Landgravine_Friederike_of_Hesse-Darmstadt
Renate_Künast	hasChild	Claudia_Roth
Otto_I,_Count_of_Savoy	isMarriedTo	Adelaide_of_Susa
Anne_of_Kiev	hasChild	Philip_I_of_France
Eunice_Kennedy_Shriver	isMarriedTo	Sargent_Shriver
Louis_XV_of_France	hasChild	Louis,_Dauphin_of_France_(1729–1765)
Peter_III_of_Portugal	hasChild	Maria_I_of_Portugal
Amalric_II_of_Jerusalem	isMarriedTo	Isabella_I_of_Jerusalem
Maria_Anna_of_Austria	isMarriedTo	John_V_of_Portugal
Philip_V_of_Spain	isMarriedTo	Elisabeth_Farnese
Anna_of_Austria,_Queen_of_Spain	hasChild	Albert_VII,_Archduke_of_Austria
John_of_Bohemia	hasChild	John_Henry,_Margrave_of_Moravia
Javed_Akhtar	hasChild	Farhan_Akhtar
Maria_Theresa_of_Austria_(1816–1867)	hasChild	Princess_Maria_Immaculata_of_Bourbon-Two_Sicilies_(1844–1899)
Maximilian_I_Joseph_of_Bavaria	hasChild	Princess_Sophie_of_Bavaria
Victor_Emmanuel_I_of_Sardinia	hasChild	Princess_Maria_Teresa_of_Savoy
Wilhelm_II_of_Germany	isMarriedTo	Augusta_Victoria_of_Schleswig-Holstein
Carlo_Buonaparte	hasChild	Lucien_Bonaparte
Eleanor_of_Austria,_Queen_of_Poland	hasChild	Marie_Casimire_Louise_de_La_Grange_d'Arquien
Nicholas_I_of_Russia	hasChild	Grand_Duke_Nicholas_Nikolaevich_of_Russia_(1831–1891)
Marie_of_Anjou	hasChild	Louis_XI_of_France
Philippe,_Duke_of_Orléans,_Regent_of_France	isMarriedTo	Françoise_Marie_de_Bourbon
Margaret_of_Durazzo	hasChild	Barbara_of_Cilli
Friedrich_Ferdinand,_Duke_of_Schleswig-Holstein	isMarriedTo	Princess_Karoline_Mathilde_of_Schleswig-Holstein-Sonderburg-Augustenburg
Adelaide_of_Meissen	hasChild	Dagmar_of_Bohemia
Dimple_Kapadia	hasChild	Twinkle_Khanna
Elisabeth_of_Valois	hasChild	Isabella_Clara_Eugenia
Umberto_I_of_Italy	isMarriedTo	Margherita_of_Savoy
Ingegerd_Olofsdotter_of_Sweden	hasChild	Anne_of_Kiev
Cosimo_I_de'_Medici,_Grand_Duke_of_Tuscany	hasChild	Francesco_I_de'_Medici,_Grand_Duke_of_Tuscany
Kīnaʻu	hasChild	Keelikōlani
Catherine_the_Great	hasChild	Paul_I_of_Russia
Hildegard_of_Vinzgouw	hasChild	Louis_the_Pious
Louise_of_Mecklenburg-Strelitz	hasChild	Prince_Albert_of_Prussia_(1809–1872)
Mamie_Eisenhower	isMarriedTo	Dwight_D._Eisenhower
Anne_Marie_d'Orléans	hasChild	Charles_Emmanuel_III_of_Sardinia
Maria_Amalia_of_Saxony	hasChild	Charles_IV_of_Spain
Landgravine_Friederike_of_Hesse-Darmstadt	isMarriedTo	Charles_II,_Grand_Duke_of_Mecklenburg-Strelitz
Constantine_I_of_Greece	isMarriedTo	Sophia_of_Prussia
Chulalongkorn	hasChild	Vajiravudh
Carl_XVI_Gustaf_of_Sweden	hasChild	Prince_Carl_Philip_of_Sweden
Beatrice_of_Savoy	isMarriedTo	Manfred,_King_of_Sicily
Alfonso_XII_of_Spain	hasChild	Alfonso_XIII_of_Spain
Princess_Isabelle_of_Orléans-Braganza	isMarriedTo	Henri,_Count_of_Paris
Isabeau_of_Bavaria	hasChild	Marie_of_Anjou
Queen_Victoria	isMarriedTo	Albert,_Prince_Consort
Honey_Irani	hasChild	Farhan_Akhtar
Ahmose_I	isMarriedTo	Ahmose-Nefertari
Queen_Paola_of_Belgium	hasChild	Queen_Mathilde_of_Belgium
Maria_Theresa	hasChild	Archduchess_Maria_Amalia_of_Austria
George_V_of_the_United_Kingdom	hasChild	George_VI_of_the_United_Kingdom
Albert_I_of_Germany	hasChild	Rudolf_I_of_Bohemia
Princess_Märtha_of_Sweden	hasChild	Harald_V_of_Norway
Frederick_William_I_of_Prussia	hasChild	Louisa_Ulrika_of_Prussia
Elena_of_Montenegro	isMarriedTo	Victor_Emmanuel_III_of_Italy
Bonne_of_Bohemia	hasChild	Louis_I,_Duke_of_Anjou
John,_Dauphin_of_France,_Duke_of_Touraine	hasChild	Charles_VII_of_France
Elisabeth,_Duchess_of_Luxembourg	hasChild	Jacqueline,_Countess_of_Hainaut
Linda_Christian	isMarriedTo	Tyrone_Power
Anthony,_Duke_of_Brabant	hasChild	Elisabeth,_Duchess_of_Luxembourg
Tim_Kaine	hasChild	Bob_McDonnell
Maria_Luisa_of_Parma	hasChild	Infante_Carlos,_Count_of_Molina
Charles_II_of_Navarre	hasChild	Joan_of_Navarre,_Queen_of_England
Margaret_I,_Countess_of_Flanders	hasChild	Yolanda_of_Flanders
Christian_II_of_Denmark	isMarriedTo	Isabella_of_Austria
Jacques_Chirac	hasChild	Raymond_Marcellin
Leopoldo_Calvo-Sotelo	isMarriedTo	José_Pedro_Pérez-Llorca
John_II_of_Aragon	isMarriedTo	Blanche_I_of_Navarre
Leopold_I,_Holy_Roman_Emperor	hasChild	Joseph_I,_Holy_Roman_Emperor
Frederick_II_of_Denmark	isMarriedTo	Sophie_of_Mecklenburg-Güstrow
Princess_Isabelle_of_Orléans_(1878–1961)	hasChild	Princess_Isabelle_of_Orléans-Braganza
Ronald_Reagan	isMarriedTo	Nancy_Reagan
Anne_of_Cyprus	isMarriedTo	Louis,_Duke_of_Savoy
Debbie_Reynolds	hasChild	Carrie_Fisher
Manuel_I_of_Portugal	hasChild	Henry,_King_of_Portugal
Philip_III_of_France	isMarriedTo	Isabella_of_Aragon
Charles_V,_Duke_of_Lorraine	hasChild	Leopold,_Duke_of_Lorraine
Joanna_Moore	isMarriedTo	Ryan_O'Neal
Kay_Johnson	isMarriedTo	John_Cromwell_(director)
Joan_Beaufort,_Queen_of_Scots	hasChild	James_II_of_Scotland
Queen_Victoria	hasChild	Edward_VII_of_the_United_Kingdom
Princess_Mary_Adelaide_of_Cambridge	hasChild	Adolphus_Cambridge,_1st_Marquess_of_Cambridge
Catherine_Pavlovna_of_Russia	isMarriedTo	William_I_of_Württemberg
Charles_III_of_Spain	hasChild	Charles_VI,_Holy_Roman_Emperor
Olav_V_of_Norway	isMarriedTo	Princess_Märtha_of_Sweden
Joan_of_Valois,_Queen_of_Navarre	isMarriedTo	Charles_II_of_Navarre
Christian_IX_of_Denmark	hasChild	Prince_Valdemar_of_Denmark
Constance_of_Sicily,_Queen_of_Aragon	isMarriedTo	Peter_III_of_Aragon
Leopold_II,_Grand_Duke_of_Tuscany	hasChild	Ferdinand_IV,_Grand_Duke_of_Tuscany
Louis_IX_of_France	hasChild	Philip_III_of_France
Paul_of_Greece	isMarriedTo	Frederica_of_Hanover
Ibn_Saud	hasChild	Nayef_bin_Abdul-Aziz_Al_Saud
George_V	hasChild	Prince_Henry,_Duke_of_Gloucester
Elizabeth_Rees-Williams	hasChild	Jared_Harris
Jacqueline,_Countess_of_Hainaut	isMarriedTo	Philip_I,_Duke_of_Brabant
Princess_Elisabeth_Sophie_of_Saxe-Altenburg	isMarriedTo	Ernest_I,_Duke_of_Saxe-Gotha
Charles_William_Ferdinand,_Duke_of_Brunswick-Wolfenbüttel	hasChild	Caroline_of_Brunswick
Theresa_of_Portugal,_Countess_of_Flanders	isMarriedTo	Philip_I,_Count_of_Flanders
Charles_V,_Holy_Roman_Emperor	isMarriedTo	Joanna_of_Castile
Sweyn_I_of_Denmark	hasChild	Eric_Haakonsson
Sophia_of_Prussia	hasChild	Alexander_of_Greece
Princess_Sophie_of_Bavaria	isMarriedTo	Archduke_Franz_Karl_of_Austria
Ferdinand_III,_Holy_Roman_Emperor	hasChild	Archduchess_Maria_Anna_Josepha_of_Austria
Françoise_Marie_de_Bourbon	isMarriedTo	Philippe,_Duke_of_Orléans,_Regent_of_France
Saovabha_Phongsri	isMarriedTo	Chulalongkorn
Barbara_Turner_(actress)	isMarriedTo	Vic_Morrow
Władysław_I_the_Elbow-high	isMarriedTo	Hedwig_of_Kalisz
Carlo_Buonaparte	hasChild	Napoleon
Charlotte_of_Mecklenburg-Strelitz	isMarriedTo	George_III_of_the_United_Kingdom
George_V	hasChild	Edward_VIII
Joséphine_de_Beauharnais	hasChild	Eugène_de_Beauharnais
Baldwin_V,_Count_of_Hainaut	hasChild	Yolanda_of_Flanders
Peter_II_of_Portugal	isMarriedTo	Maria_Francisca_of_Savoy
Miguel_I_of_Portugal	hasChild	Maria_II_of_Portugal
Isabella_Clara_Eugenia	hasChild	Philip_IV_of_Spain
Louis,_Dauphin_of_France_(1729–1765)	hasChild	Louis_XVIII_of_France
Eleonor_Magdalene_of_Neuburg	hasChild	Joseph_I,_Holy_Roman_Emperor
Princess_Augusta_Wilhelmine_of_Hesse-Darmstadt	hasChild	Therese_of_Saxe-Hildburghausen
Afonso_II_of_Portugal	hasChild	Afonso_III_of_Portugal
Albert_I_of_Germany	isMarriedTo	Elizabeth_of_Carinthia,_Queen_of_Germany
Danielle_Mitterrand	isMarriedTo	François_Mitterrand
Mary_of_Teck	isMarriedTo	George_V_of_the_United_Kingdom
Roger_II_of_Sicily	isMarriedTo	William_I_of_Sicily
Victor_Emmanuel_I_of_Sardinia	hasChild	Maria_Anna_of_Savoy
Isabella_of_Castile	hasChild	Germaine_of_Foix
André_Rossinot	isMarriedTo	Jean-Louis_Borloo
Juliana_of_the_Netherlands	isMarriedTo	Prince_Bernhard_of_Lippe-Biesterfeld
Martha_Washington	hasChild	Abigail_Adams
Frederick_III,_German_Emperor	isMarriedTo	Victoria,_Princess_Royal
Charlie_Chaplin	hasChild	Geraldine_Chaplin
Philip_II_of_France	isMarriedTo	Agnes_of_Merania
Louis_VIII_of_France	hasChild	Louis_IX_of_France
Charles_IV,_Holy_Roman_Emperor	isMarriedTo	Anna_von_Schweidnitz
Princess_Augusta_Wilhelmine_of_Hesse-Darmstadt	hasChild	Ludwig_I_of_Bavaria
Dorothea_Maria_of_Anhalt	hasChild	William,_Duke_of_Saxe-Weimar
Infanta_Marie_Anne_of_Portugal	hasChild	Prince_Felix_of_Bourbon-Parma
Joan_of_France,_Duchess_of_Berry	hasChild	Catherine_of_Medici
Leopold_II,_Holy_Roman_Emperor	hasChild	Ferdinand_III,_Grand_Duke_of_Tuscany
Elizabeth_of_Luxembourg	hasChild	Eleanor_of_Portugal,_Holy_Roman_Empress
Empress_Elisabeth_of_Austria	isMarriedTo	Franz_Joseph_I_of_Austria
Charles_VII,_Holy_Roman_Emperor	isMarriedTo	Maria_Amalia_of_Austria
Charles_II_of_Naples	hasChild	Margaret,_Countess_of_Anjou
Oscar_II_of_Sweden	hasChild	Gustaf_V_of_Sweden
Ramon_Berenguer_IV,_Count_of_Provence	hasChild	Beatrice_of_Savoy
Princess_Marie_of_Orléans_(1865–1909)	hasChild	Prince_Axel_of_Denmark
Dorothea_of_Saxe-Lauenburg	hasChild	Sophie_of_Mecklenburg-Güstrow
Margravine_Friederike_of_Brandenburg-Schwedt	hasChild	Duke_Louis_of_Württemberg
Salomea_of_Berg	hasChild	Agnes_of_Babenberg
Barbara_of_Cilli	isMarriedTo	Jobst_of_Moravia
Wilhelm_II_of_Germany	hasChild	Prince_Eitel_Friedrich_of_Prussia
Ted_Kennedy	isMarriedTo	Joan_Bennett_Kennedy
Élisabeth_Charlotte_d'Orléans	isMarriedTo	Leopold,_Duke_of_Lorraine
Queen_Sofía_of_Spain	isMarriedTo	Juan_Carlos_I_of_Spain
Bona_of_Savoy	hasChild	Bianca_Maria_Sforza
Maria_Sophia_of_Neuburg	hasChild	Maria_Anna_of_Austria
Eleonora_Gonzaga_(1630–1686)	hasChild	Archduchess_Maria_Anna_Josepha_of_Austria
Maximilian_I_Joseph_of_Bavaria	isMarriedTo	Caroline_of_Baden
Anne_Marie_d'Orléans	hasChild	Maria_Luisa_of_Savoy
Marie_of_Brabant,_Queen_of_France	hasChild	Joan_I_of_Navarre
Maximilian_I_Joseph_of_Bavaria	hasChild	Princess_Ludovika_of_Bavaria
Ján_Figeľ	isMarriedTo	Erkki_Liikanen
Louis_XIV_of_France	hasChild	Charles_II_of_Spain
Abby_Aldrich_Rockefeller	isMarriedTo	John_D._Rockefeller,_Jr.
John_III_of_Sweden	hasChild	Sigismund_III_Vasa
John_II,_Duke_of_Saxe-Weimar	isMarriedTo	Dorothea_Maria_of_Anhalt
William_I,_German_Emperor	hasChild	Princess_Louise_of_Prussia
Augustus_III_of_Poland	hasChild	Maria_Josepha_of_Saxony,_Dauphine_of_France
Jack_Cassidy	hasChild	Shaun_Cassidy
Peter_II_of_Portugal	hasChild	Miguel,_Duke_of_Braganza
Ahmose_I	hasChild	Amenhotep_I
Leopold_II_of_Belgium	hasChild	Albert_I_of_Belgium
Jada_Pinkett_Smith	isMarriedTo	Will_Smith
Cleopatra_Thea	hasChild	Antiochus_VIII_Grypus
Winston_Churchill	hasChild	Anthony_Eden
Cornelius_Vanderbilt_II	hasChild	Cornelius_Vanderbilt_III
Ann_Dunham	hasChild	Maya_Soetoro-Ng
Hedwig_of_Kalisz	hasChild	Casimir_III_of_Poland
Louis_VI_of_France	isMarriedTo	Adelaide_of_Maurienne
Elizabeth_Richeza_of_Poland	isMarriedTo	Rudolf_I_of_Bohemia
Maria_Feodorovna_(Sophie_Dorothea_of_Württemberg)	hasChild	Grand_Duchess_Maria_Pavlovna_of_Russia_(1786–1859)
Richard_Nixon	isMarriedTo	Pat_Nixon
Maximilian_II,_Holy_Roman_Emperor	hasChild	Maximilian_III,_Archduke_of_Austria
Sophia_of_Prussia	hasChild	George_II_of_Greece
Peter_III_of_Russia	hasChild	Paul_I_of_Russia
Louis_XII_of_France	hasChild	Francis_I_of_France
Marie_de'_Medici	hasChild	Henrietta_Maria_of_France
Eleanor_of_Austria,_Queen_of_Poland	hasChild	Leopold,_Duke_of_Lorraine
Victor_Amadeus_II_of_Sardinia	hasChild	Maria_Luisa_of_Savoy
John_VI_of_Portugal	isMarriedTo	Carlota_Joaquina_of_Spain
Umberto_I_of_Italy	hasChild	Victor_Emmanuel_III_of_Italy
Maria_Feodorovna_(Sophie_Dorothea_of_Württemberg)	hasChild	Grand_Duchess_Anna_Pavlovna_of_Russia
Maximilian_I,_Holy_Roman_Emperor	hasChild	Philip_I_of_Castile
Vincente_Minnelli	hasChild	Liza_Minnelli
Eleanor_of_Aquitaine	isMarriedTo	John_of_England
Princess_Maria_Antonia_of_the_Two_Sicilies	isMarriedTo	Leopold_II,_Grand_Duke_of_Tuscany
Louis_XV_of_France	hasChild	Louise_Élisabeth_of_France
Baldwin_I_of_Constantinople	hasChild	Marie_of_Champagne
Louis_I_of_Spain	hasChild	Ferdinand_VI_of_Spain
Imelda_Marcos	hasChild	Imee_Marcos
Maria_Amalia_of_Austria	hasChild	Maria_Theresa_of_Austria
Claude_of_Valois	isMarriedTo	Charles_III,_Duke_of_Lorraine
Eleonor_Magdalene_of_Neuburg	isMarriedTo	Leopold_I,_Holy_Roman_Emperor
Prince_Felix_of_Bourbon-Parma	hasChild	Jean,_Grand_Duke_of_Luxembourg
Caroline_Bonaparte	hasChild	Prince_Achille_Murat
Isabella_of_Valois	isMarriedTo	Richard_II_of_England
Augusta_Victoria_of_Schleswig-Holstein	isMarriedTo	Wilhelm_II,_German_Emperor
Henrietta_Maria_of_France	hasChild	Charles_II_of_England
Fernando_II_of_Portugal	hasChild	Infanta_Maria_Anna_of_Portugal_(1843–1884)
Barbara_of_Cilli	hasChild	Eleanor_of_Portugal,_Holy_Roman_Empress
Charles_VI_of_France	hasChild	Isabella_of_Valois
S._W._R._D._Bandaranaike	isMarriedTo	Sirimavo_Bandaranaike
Rose_Kennedy	hasChild	Eunice_Kennedy_Shriver
Elisabeth_Farnese	isMarriedTo	Philip_V_of_Spain
Keohokālole	isMarriedTo	Kapaakea
Marie_of_Brabant,_Queen_of_France	isMarriedTo	Philip_III_of_France
Princess_Maria_Teresa_of_Savoy	hasChild	Charles_III,_Duke_of_Parma
Ferdinand,_Duke_of_Parma	isMarriedTo	Archduchess_Maria_Amalia_of_Austria
Victor_Amadeus_III_of_Sardinia	hasChild	Victor_Emmanuel_I_of_Sardinia
Elisabeth_of_France_(1602–1644)	hasChild	Marie_Thérèse_of_Austria
Edward_III_of_England	hasChild	Lionel_of_Antwerp,_1st_Duke_of_Clarence
Elisabeth_Christine_of_Brunswick-Wolfenbüttel	hasChild	Maria_Theresa_of_Austria
Tim_Kaine	isMarriedTo	Mark_Warner
Maria_Luisa_of_Savoy	hasChild	Louis_I_of_Spain
Prince_Philippe,_Count_of_Paris	hasChild	Princess_Isabelle_of_Orléans_(1878–1961)
Agnes_of_Babenberg	hasChild	Mieszko_IV_Tanglefoot
Ernest_I,_Duke_of_Saxe-Gotha	hasChild	Bernhard_I,_Duke_of_Saxe-Meiningen
Anne_Marie_Louise_d'Orléans,_Duchess_of_Montpensier	hasChild	Philippe,_Duke_of_Orléans
Ulrika_Eleonora_of_Denmark	hasChild	Ulrika_Eleonora,_Queen_of_Sweden
Wenceslaus_II_of_Bohemia	hasChild	Wenceslaus_III_of_Bohemia
Henry_I_of_France	isMarriedTo	Anne_of_Kiev
William_II_of_the_Netherlands	isMarriedTo	Grand_Duchess_Anna_Pavlovna_of_Russia
Sophia_of_Minsk	isMarriedTo	Valdemar_I_of_Denmark
Amélie_of_Leuchtenberg	hasChild	Teresa_Cristina_of_the_Two_Sicilies
Paul_I_of_Russia	hasChild	Alexander_I_of_Russia
Charlemagne	hasChild	Louis_the_Pious
Leopold_II,_Holy_Roman_Emperor	hasChild	Francis_II,_Holy_Roman_Emperor
Louis_XII_of_France	isMarriedTo	Mary_Tudor,_Queen_of_France
Nicholas_I_of_Montenegro	hasChild	Elena_of_Montenegro
Galeazzo_Maria_Sforza	isMarriedTo	Bona_of_Savoy
Edward_II_of_England	isMarriedTo	Isabella_of_France
Supriya_Pathak	isMarriedTo	Pankaj_Kapur
Philip_IV_of_Spain	hasChild	Margaret_Theresa_of_Spain
Bolesław_III_Wrymouth	isMarriedTo	Salomea_of_Berg
Augustus	isMarriedTo	Livia
Ralph_de_Neville,_1st_Earl_of_Westmorland	isMarriedTo	Joan_Beaufort,_Countess_of_Westmorland
Gordon_Brown	isMarriedTo	Sarah_Jane_Brown
Empress_Matilda	hasChild	Richenza_of_Northeim
Constance_of_Sicily,_Queen_of_Aragon	hasChild	James_II_of_Aragon
Sophia_Dorothea_of_Hanover	hasChild	Elisabeth_Christine_of_Brunswick-Wolfenbüttel-Bevern
Sigrid_the_Haughty	hasChild	Sweyn_I_of_Denmark
Princess_Maria_Teresa_of_Savoy	isMarriedTo	Charles_II,_Duke_of_Parma
Isabella_of_Castile	hasChild	Catherine_of_Aragon
Frederick_William_II_of_Prussia	isMarriedTo	Frederika_Louisa_of_Hesse-Darmstadt
Raynald_of_Châtillon	isMarriedTo	Constance_of_Antioch
Maria_Josepha_of_Austria	hasChild	Maria_Josepha_of_Saxony,_Dauphine_of_France
Anna_Pavlovna_of_Russia	hasChild	William_III_of_the_Netherlands
Henry_IV_of_England	hasChild	John_of_Lancaster,_1st_Duke_of_Bedford
Elisabeth_of_Bavaria,_Queen_of_Belgium	isMarriedTo	Albert_I_of_Belgium
Grand_Duchess_Maria_Pavlovna_of_Russia_(1786–1859)	isMarriedTo	Charles_Frederick,_Grand_Duke_of_Saxe-Weimar-Eisenach
Joan_of_France,_Duchess_of_Berry	hasChild	Anne_of_Brittany
Maria_Anna_of_Bavaria_(1574–1616)	isMarriedTo	Ferdinand_II,_Holy_Roman_Emperor
Edward_VII	isMarriedTo	Alexandra_of_Denmark
Joseph_I,_Holy_Roman_Emperor	isMarriedTo	Wilhelmine_Amalia_of_Brunswick-Lüneburg
Queen_Elizabeth_The_Queen_Mother	isMarriedTo	George_VI_of_the_United_Kingdom
Maria_Cristina_of_Savoy	hasChild	Francis_II_of_the_Two_Sicilies
Alexandra_Feodorovna_(Charlotte_of_Prussia)	isMarriedTo	Nicholas_I_of_Russia
Victor_Emmanuel_II_of_Savoy	isMarriedTo	Adelaide_of_Austria
Ingegerd_Olofsdotter_of_Sweden	hasChild	Iziaslav_I_of_Kiev
Charles_VI_of_France	hasChild	John,_Dauphin_of_France,_Duke_of_Touraine
Agnes_of_Babenberg	hasChild	Bolesław_I_the_Tall
Emma_of_Normandy	hasChild	Gunhilda_of_Denmark
Anna_of_Austria,_Queen_of_Spain	hasChild	Philip_III_of_Spain
Infanta_Marie_Anne_of_Portugal	isMarriedTo	William_IV,_Grand_Duke_of_Luxembourg
Philip_V_of_Spain	hasChild	Mariana_Victoria_of_Spain
Robert_II_of_France	hasChild	Adela_of_France,_Countess_of_Flanders
Abraham_Lincoln	hasChild	Andrew_Johnson
Augustus_III_of_Poland	hasChild	Princess_Maria_Josepha_of_Saxony_(1731–1767)
Mumtaz_Mahal	hasChild	Aurangzeb
Constance,_Queen_of_Sicily	isMarriedTo	Henry_VI,_Holy_Roman_Emperor
Edward_IV_of_England	isMarriedTo	Elizabeth_Woodville
Christina_of_Saxony	hasChild	Christian_II_of_Denmark
Gertrude_of_Süpplingenburg	isMarriedTo	Henry_II,_Duke_of_Austria
S._W._R._D._Bandaranaike	hasChild	Chandrika_Kumaratunga
Paul_I_of_Russia	hasChild	Grand_Duchess_Maria_Pavlovna_of_Russia_(1786–1859)
Victor_Amadeus_III_of_Sardinia	isMarriedTo	Maria_Antonia_Ferdinanda_of_Spain
Elisabeth_of_Bavaria,_Queen_of_Belgium	hasChild	Astrid_of_Sweden
Princess_Maria_Annunciata_of_Bourbon-Two_Sicilies	hasChild	Archduke_Franz_Ferdinand_of_Austria
Wilhelm_II,_German_Emperor	hasChild	Prince_August_Wilhelm_of_Prussia
Sarah_Jane_Brown	isMarriedTo	Gordon_Brown
Elisabeth_Christine_of_Brunswick-Wolfenbüttel	hasChild	Maria_Amalia_of_Saxony
Constance_of_Aragon	hasChild	Margaret_of_Austria,_Queen_of_Bohemia
Isabella_of_Angoulême	hasChild	Isabella_of_England
Catherine_Howard	isMarriedTo	Henry_VIII_of_England
Alexandra_of_Denmark	hasChild	George_V_of_the_United_Kingdom
Philip_IV_of_France	isMarriedTo	Joan_I_of_Navarre
John_Quincy_Adams	hasChild	Charles_Francis_Adams,_Sr.
Caroline_Augusta_of_Bavaria	isMarriedTo	Francis_II,_Holy_Roman_Emperor
Leopold,_Duke_of_Lorraine	isMarriedTo	Élisabeth_Charlotte_d'Orléans
Frederick_II_Eugene,_Duke_of_Württemberg	hasChild	Frederick_I_of_Württemberg
Elisabeth_Christine_of_Brunswick-Wolfenbüttel	hasChild	Maria_Theresa
Vincente_Minnelli	isMarriedTo	Judy_Garland
Vittorio_Emanuele_III	hasChild	Haile_Selassie_I_of_Ethiopia
Marie_Jeanne_Baptiste_of_Savoy-Nemours	isMarriedTo	Charles_Emmanuel_II,_Duke_of_Savoy
Elisabeth_of_France_(1602–1644)	hasChild	Maria_Theresa_of_Spain
Sargent_Shriver	isMarriedTo	Eunice_Kennedy_Shriver
Anne_Eleonore_of_Hesse-Darmstadt	hasChild	Ernest_Augustus,_Elector_of_Brunswick-Lüneburg
Anna_of_Austria,_Queen_of_Spain	hasChild	Margaret_of_Austria,_Queen_of_Spain
Princess_Augusta_of_Bavaria	isMarriedTo	Eugène_de_Beauharnais
Lilian,_Princess_of_Réthy	isMarriedTo	Leopold_III_of_Belgium
Charles_William_Ferdinand,_Duke_of_Brunswick-Wolfenbüttel	isMarriedTo	Princess_Augusta_of_Great_Britain
Alice_Claypoole_Gwynne	hasChild	Gertrude_Vanderbilt_Whitney
Princess_Louise_Caroline_of_Hesse-Kassel	hasChild	Christian_IX_of_Denmark
Maria_I_of_Portugal	hasChild	John_VI_of_Portugal
Will_Smith	hasChild	Jaden_Smith
Casimir_IV_Jagiellon	hasChild	Alexander_Jagiellon
Bertha_of_Savoy	isMarriedTo	Henry_IV,_Holy_Roman_Emperor
Henry_II_of_England	isMarriedTo	Eleanor_of_Aquitaine
Hedwig_of_Kalisz	hasChild	Aldona_of_Lithuania
Gustaf_VI_Adolf_of_Sweden	hasChild	Carl_XVI_Gustaf_of_Sweden
Henrietta_Maria_of_France	isMarriedTo	Charles_I_of_England
Francis_I,_Holy_Roman_Emperor	isMarriedTo	Maria_Theresa_of_Austria
Empress_Elisabeth_of_Austria	hasChild	Archduchess_Gisela_of_Austria
Charles_VIII_of_France	isMarriedTo	Anne_of_Brittany
Władysław_I_the_Elbow-high	hasChild	Casimir_III_the_Great
Sibylla,_Queen_of_Jerusalem	isMarriedTo	Guy_of_Lusignan
Victoria,_Princess_Royal	isMarriedTo	Frederick_III,_German_Emperor
Agnes_of_Burgundy,_Duchess_of_Aquitaine	isMarriedTo	William_V,_Duke_of_Aquitaine
Elisabeth_of_Habsburg_(1436–1505)	hasChild	John_I_Albert
Queen_Elizabeth_The_Queen_Mother	isMarriedTo	George_VI
Marie_Thérèse_of_Austria	hasChild	Marie_Leszczyńska
George_VI	hasChild	Elizabeth_II
Louise_of_Hesse-Kassel	isMarriedTo	Christian_IX_of_Denmark
Augustus_III_of_Poland	hasChild	Frederick_Christian,_Elector_of_Saxony
Maria_Theresa_of_Austria	hasChild	Marie_Antoinette
Juan_Carlos_I_of_Spain	hasChild	Infanta_Cristina,_Duchess_of_Palma_de_Mallorca
Catherine_I_of_Russia	hasChild	Peter_II_of_Russia
Louis_XI_of_France	isMarriedTo	Charlotte_of_Savoy
Louisa_Adams	isMarriedTo	John_Quincy_Adams
Elizabeth_of_Bosnia	hasChild	Mary,_Queen_of_Hungary
Ferdinand_II_of_the_Two_Sicilies	isMarriedTo	Maria_Theresa_of_Austria,_Queen_of_the_Two_Sicilies
Elisabeth_Christine_of_Brunswick-Wolfenbüttel	hasChild	Francis_I,_Holy_Roman_Emperor
Marie_de'_Medici	hasChild	Anne_of_Austria
Maria_Luisa_of_Spain	hasChild	Archduke_Joseph,_Palatine_of_Hungary
Charles_I_of_Naples	isMarriedTo	Beatrice_of_Provence
Elisabeth,_Duchess_of_Luxembourg	isMarriedTo	Anthony,_Duke_of_Brabant
Juan_Perón	isMarriedTo	Eva_Perón
Françoise_Marie_de_Bourbon	isMarriedTo	Philippe_II,_Duke_of_Orléans
Louis_I_of_Hungary	isMarriedTo	Elizabeth_of_Bosnia
Archduchess_Maria_Amalia_of_Austria	hasChild	Louis,_King_of_Etruria
Béla_III_of_Hungary	isMarriedTo	Agnes_of_Antioch
Grand_Duke_Michael_Nikolaevich_of_Russia	hasChild	Grand_Duke_George_Mikhailovich_of_Russia_(1863–1919)
Frederick_I,_Grand_Duke_of_Baden	hasChild	Victoria_of_Baden
Queen_Victoria	hasChild	Princess_Beatrice_of_the_United_Kingdom
Eleanor_of_Naples,_Duchess_of_Ferrara	hasChild	Alfonso_I_d'Este,_Duke_of_Ferrara
Claudius	hasChild	Messalina
Eunice_Kennedy_Shriver	hasChild	Maria_Shriver
Margaret_of_Austria,_Queen_of_Bohemia	isMarriedTo	Ottokar_II_of_Bohemia
Amalie_Auguste_of_Bavaria	hasChild	Albert_of_Saxony
Javed_Akhtar	isMarriedTo	Honey_Irani
Albert,_Prince_Consort	hasChild	Princess_Beatrice_of_the_United_Kingdom
Princess_Maria_Antonietta_of_Bourbon-Two_Sicilies	hasChild	Prince_Carlos_of_Bourbon-Two_Sicilies
Robert_II,_Duke_of_Burgundy	isMarriedTo	Agnes_of_France,_Duchess_of_Burgundy
Maria_Beatrice_d'Este,_Duchess_of_Massa	hasChild	Francis_IV,_Duke_of_Modena
Duchess_Maria_Anna_Victoria_of_Bavaria	hasChild	Louis,_Dauphin_of_France,_Duke_of_Burgundy
Renate_Künast	hasChild	Jürgen_Trittin
Casimir_III_of_Poland	hasChild	Elizabeth_of_Poland,_Queen_of_Hungary
Louis_XIV_of_France	hasChild	Françoise_Marie_de_Bourbon
John_of_England	hasChild	Isabella_of_England
Henry_Ephron	isMarriedTo	Phoebe_Ephron
Yaroslav_the_Wise	hasChild	Iziaslav_I_of_Kiev
Jacqueline_Kennedy_Onassis	isMarriedTo	John_F._Kennedy
Constance_of_Antioch	hasChild	Agnes_of_Antioch
John_IV,_Duke_of_Brittany	hasChild	John_V,_Duke_of_Brittany
Olga_Feodorovna_of_Baden	isMarriedTo	Grand_Duke_Michael_Nikolaevich_of_Russia
Charlie_Chaplin	isMarriedTo	Oona_O'Neill
Hedwig_of_Sagan	hasChild	Elizabeth_of_Bosnia
Anne_of_Cyprus	hasChild	Charlotte_of_Savoy
Alexander_III_of_Russia	isMarriedTo	Maria_Feodorovna_(Dagmar_of_Denmark)
Prince_Philippe,_Count_of_Paris	isMarriedTo	Princess_Marie_Isabelle_of_Orléans
Ibn_Saud	hasChild	Muqrin_bin_Abdulaziz_Al_Saud
Elizabeth_Stuart,_Queen_of_Bohemia	hasChild	Sophia_of_Hanover
Meinhard,_Duke_of_Carinthia	hasChild	Elizabeth_of_Carinthia,_Queen_of_Germany
Victoria,_Princess_Royal	isMarriedTo	Friedrich_III_of_Germany
Ibn_Saud	isMarriedTo	Hassa_bint_Ahmed_Al_Sudairi
Cnut_the_Great	isMarriedTo	Emma_of_Normandy
Maria_Luisa_of_Spain	isMarriedTo	Leopold_II,_Holy_Roman_Emperor
Christian_II_of_Denmark	hasChild	Frederick_I_of_Denmark
Marie_of_Romania	hasChild	Maria_of_Yugoslavia
Maximilian_I_Joseph_of_Bavaria	hasChild	Ludwig_I_of_Bavaria
Dulce_of_Aragon	isMarriedTo	Sancho_I_of_Portugal
Frederick_VIII_of_Denmark	hasChild	Haakon_VII_of_Norway
Marcus_Vipsanius_Agrippa	isMarriedTo	Julia_the_Elder
Maria_Anna_of_Bavaria_(1551–1608)	hasChild	Ferdinand_II,_Holy_Roman_Emperor
María_Isabella_of_Spain	isMarriedTo	Francis_I_of_the_Two_Sicilies
Alfonso_XII_of_Spain	isMarriedTo	Maria_Christina_of_Austria
Empress_Teimei	hasChild	Hirohito
Kekūanāoa	hasChild	Kamehameha_IV
Letizia_Ramolino	hasChild	Jérôme_Bonaparte
Henry_IV_of_France	hasChild	Henrietta_Maria_of_France
Francis_I,_Holy_Roman_Emperor	hasChild	Maria_Christina,_Duchess_of_Teschen
Alexandra_Feodorovna_(Charlotte_of_Prussia)	hasChild	Grand_Duchess_Maria_Nikolaevna_of_Russia_(1819–1876)
Carlo_Buonaparte	hasChild	Jérôme_Bonaparte
Beatrice_I,_Countess_of_Burgundy	hasChild	Constance,_Queen_of_Sicily
Infanta_Catherine_Michelle_of_Spain	hasChild	Victor_Amadeus_I,_Duke_of_Savoy
Gerald_Ford	hasChild	Nelson_Rockefeller
Bruce_Paltrow	isMarriedTo	Blythe_Danner
Maria_Theresa_of_Austria,_Queen_of_the_Two_Sicilies	isMarriedTo	Ferdinand_II_of_the_Two_Sicilies
Emperor_Taishō	isMarriedTo	Empress_Teimei
Princess_Sophie_of_Bavaria	hasChild	Maximilian_I_of_Mexico
Edward_I_of_England	isMarriedTo	Margaret_of_France,_Queen_of_England
Henry_IV,_Holy_Roman_Emperor	hasChild	Henry_V,_Holy_Roman_Emperor
Wenceslaus_I,_Duke_of_Luxembourg	hasChild	Joanna,_Duchess_of_Brabant
Nancy_Reagan	hasChild	Barbara_Bush
Wilhelm_I_of_Germany	isMarriedTo	Augusta_of_Saxe-Weimar-Eisenach
Ernest_Augustus_I_of_Hanover	hasChild	Victoria,_Princess_Royal
Prince_Bernhard_of_the_Netherlands	hasChild	Princess_Irene_of_the_Netherlands
Landgravine_Friederike_of_Hesse-Darmstadt	hasChild	Frederica_of_Mecklenburg-Strelitz
Adolf_Frederick_of_Sweden	hasChild	Charles_XIII_of_Sweden
Francisco_da_Costa_Gomes	hasChild	Adelino_da_Palma_Carlos
George_I_of_Greece	hasChild	Constantine_I_of_Greece
Duke_Henry_of_Mecklenburg-Schwerin	hasChild	Prince_Bernhard_of_the_Netherlands
John_III_Sobieski	hasChild	Augustus_II_the_Strong
William_I_of_Württemberg	hasChild	Sophie_of_Württemberg
Francis,_Duke_of_Teck	hasChild	Alexander_Cambridge,_1st_Earl_of_Athlone
Rajesh_Khanna	hasChild	Rinke_Khanna
Archduke_Karl_Ferdinand_of_Austria	hasChild	Archduke_Charles_Stephen_of_Austria
Frederick_I_of_Sweden	hasChild	Ulrika_Eleonora,_Queen_of_Sweden
Philip_II_of_Spain	hasChild	Philip_III_of_Spain
John_VI,_Duke_of_Brittany	isMarriedTo	Joan_of_France,_Duchess_of_Brittany
José_Baptista_Pinheiro_de_Azevedo	isMarriedTo	Carlos_Galvão_de_Melo
Charles_VII,_Holy_Roman_Emperor	hasChild	Maria_Theresa_of_Austria
Alexander_II_of_Russia	hasChild	Grand_Duke_Alexei_Alexandrovich_of_Russia
Sweyn_I_of_Denmark	hasChild	Ethelred_the_Unready
Babita	hasChild	Karisma_Kapoor
Louis_VII_of_France	hasChild	Philip_II_of_France
Maria_Theresa	hasChild	Joseph_II,_Holy_Roman_Emperor
Elizabeth_of_Bohemia_(1292–1330)	hasChild	Bonne_of_Bohemia
Maria_Carolina_of_Austria	isMarriedTo	Ferdinand_I_of_the_Two_Sicilies
George_C._Scott	hasChild	Campbell_Scott
Margaret_I,_Countess_of_Flanders	hasChild	Isabelle_of_Hainaut
Christian_I_of_Denmark	hasChild	Frederick_I_of_Denmark
Frederick_II,_Holy_Roman_Emperor	hasChild	Manfred,_King_of_Sicily
Caroline_of_Baden	isMarriedTo	Maximilian_I_Joseph_of_Bavaria
Marie_of_Romania	hasChild	Prince_Nicholas_of_Romania
Mamie_Eisenhower	hasChild	John_Eisenhower
Frederica_of_Hanover	hasChild	Constantine_II_of_Greece
Louis_II_of_Naples	isMarriedTo	Yolande_of_Aragon
Charles_III_of_Spain	hasChild	Ferdinand_I_of_the_Two_Sicilies
Isabella_of_Austria	isMarriedTo	Christian_II_of_Denmark
Valdemar_I_of_Denmark	hasChild	Valdemar_II_of_Denmark
Albert_II_of_Belgium	hasChild	Philippe_of_Belgium
Ludwig_III_of_Bavaria	hasChild	Prince_Franz_of_Bavaria
Maria_Antonia_Ferdinanda_of_Spain	isMarriedTo	Victor_Amadeus_III_of_Sardinia
Louise_of_Sweden	hasChild	Princess_Ingeborg_of_Denmark
Ferdinand_Albert_II,_Duke_of_Brunswick-Wolfenbüttel	hasChild	Elisabeth_Christine_of_Brunswick-Wolfenbüttel-Bevern
Prince_Philippe,_Count_of_Paris	hasChild	Amélie_of_Orléans
Casimir_I_the_Restorer	isMarriedTo	Iziaslav_I_of_Kiev
Francis_I_of_France	isMarriedTo	Claude_of_France
Sibylla,_Queen_of_Jerusalem	hasChild	Guy_of_Lusignan
Archduke_Franz_Karl_of_Austria	isMarriedTo	Princess_Sophie_of_Bavaria
Ferdinand_II_of_Aragon	hasChild	Catherine_of_Aragon
Henry_II_of_England	hasChild	John,_King_of_England
Princess_Louise_of_Prussia	hasChild	Victoria_of_Baden
Henry_II_of_France	hasChild	Claude_of_Valois
Amélie_of_Leuchtenberg	isMarriedTo	Pedro_I_of_Brazil
Dharmendra	hasChild	Esha_Deol
Rishi_Kapoor	hasChild	Ranbir_Kapoor
Margo_(actress)	hasChild	Edward_Albert
Paul_I_of_Russia	hasChild	Grand_Duke_Michael_Pavlovich_of_Russia
Mary_I_of_England	hasChild	Elisabeth_of_Valois
Desi_Arnaz	hasChild	Desi_Arnaz,_Jr.
Louis_XIV_of_France	isMarriedTo	Françoise_d'Aubigné,_Marquise_de_Maintenon
Joan_of_Navarre,_Queen_of_England	hasChild	Catherine_of_Valois
Ottokar_I_of_Bohemia	isMarriedTo	Adelaide_of_Meissen
Maria_Sophia_of_Neuburg	isMarriedTo	Peter_II_of_Portugal
Pankaj_Kapur	hasChild	Shahid_Kapoor
Maria_Alexandrovna_(Marie_of_Hesse)	hasChild	Alexander_III_of_Russia
Albert_II_of_Belgium	isMarriedTo	Queen_Paola_of_Belgium
Sophia_Dorothea_of_Hanover	isMarriedTo	Frederick_William_I_of_Prussia
John_II_of_France	isMarriedTo	Bonne_of_Bohemia
Wenceslaus_I,_Duke_of_Luxembourg	isMarriedTo	Joanna,_Duchess_of_Brabant
Joan_of_Navarre,_Queen_of_England	hasChild	Arthur_III,_Duke_of_Brittany
Eva_Perón	hasChild	Juan_Perón
Henrik,_Prince_Consort_of_Denmark	isMarriedTo	Margrethe_II_of_Denmark
Victoria_Eugenie_of_Battenberg	hasChild	Infante_Juan,_Count_of_Barcelona
Ulrika_Eleonora,_Queen_of_Sweden	isMarriedTo	Frederick_I_of_Sweden
Ferdinand,_Duke_of_Breisgau	isMarriedTo	Maria_Beatrice_d'Este,_Duchess_of_Massa
Fernando_II_of_Portugal	hasChild	Pedro_V_of_Portugal
Isabella_of_Valois	isMarriedTo	Peter_I,_Duke_of_Bourbon
Bernadette_Chirac	hasChild	Cécilia_Attias
Philip_of_Swabia	hasChild	Otto_IV,_Holy_Roman_Emperor
Elizabeth_Woodville	hasChild	Elizabeth_of_York
Roger_II_of_Sicily	hasChild	Constance,_Queen_of_Sicily
Hassa_bint_Ahmed_Al_Sudairi	isMarriedTo	Ibn_Saud
Soong_May-ling	isMarriedTo	Chiang_Kai-shek
Philip_V_of_Spain	hasChild	Charles_VI,_Holy_Roman_Emperor
Francis_I,_Holy_Roman_Emperor	hasChild	Marie_Antoinette
Maria_Josepha_of_Austria	hasChild	Princess_Maria_Josepha_of_Saxony_(1731–1767)
Maria_Luisa_of_Savoy	hasChild	Elisabeth_Christine_of_Brunswick-Wolfenbüttel
Francis,_Duke_of_Saxe-Coburg-Saalfeld	isMarriedTo	Countess_Augusta_Reuss_of_Ebersdorf
Béla_IV_of_Hungary	isMarriedTo	Maria_Laskarina
Maximilian_I_Joseph_of_Bavaria	hasChild	Amalie_Auguste_of_Bavaria
Philip_V_of_Spain	isMarriedTo	Elisabetta_Farnese
Francis_IV,_Duke_of_Modena	hasChild	Archduke_Ferdinand_Karl_Viktor_of_Austria-Este
Charles_II,_Archduke_of_Austria	hasChild	Ferdinand_II,_Holy_Roman_Emperor
Talal_of_Jordan	hasChild	Hussein_of_Jordan
Marie_Antoinette	hasChild	Joséphine_de_Beauharnais
Maria_Alexandrovna_(Marie_of_Hesse)	hasChild	Grand_Duke_Vladimir_Alexandrovich_of_Russia
Richard_Harris	hasChild	Damian_Harris
John_of_Saxony	hasChild	George,_King_of_Saxony
Queen_Silvia_of_Sweden	isMarriedTo	Carl_XVI_Gustaf_of_Sweden
Wenceslaus_II_of_Bohemia	isMarriedTo	Elizabeth_Richeza_of_Poland
Martha_Bulloch_Roosevelt	isMarriedTo	Theodore_Roosevelt,_Sr.
Maria_Feodorovna_(Sophie_Dorothea_of_Württemberg)	hasChild	Nicholas_I_of_Russia
Cleopatra_II_of_Egypt	isMarriedTo	Ptolemy_VIII_Physcon
Louise_of_Sweden	hasChild	Haakon_VII_of_Norway
Frederick_I_of_Sweden	hasChild	Adolf_Frederick_of_Sweden
Maria_Feodorovna_(Dagmar_of_Denmark)	hasChild	Grand_Duke_Michael_Alexandrovich_of_Russia
Ferdinand_II,_Holy_Roman_Emperor	hasChild	Ferdinand_III,_Holy_Roman_Emperor
Sancho_I_of_Portugal	isMarriedTo	Dulce_of_Aragon
Princess_María_de_las_Mercedes_of_Bourbon-Two_Sicilies	hasChild	Juan_Carlos_I_of_Spain
Naomi_Foner_Gyllenhaal	hasChild	Maggie_Gyllenhaal
Juliana_of_the_Netherlands	hasChild	Beatrix_of_the_Netherlands
Princess_Augusta_of_Great_Britain	hasChild	Caroline_of_Brunswick
Joan_I_of_Navarre	hasChild	Louis_X_of_France
Beatrice_I,_Countess_of_Burgundy	isMarriedTo	Frederick_I,_Holy_Roman_Emperor
Isabella_I_of_Jerusalem	hasChild	Alice_of_Champagne
Eleanor_of_Aquitaine	isMarriedTo	Henry_II_of_England
Constance_of_Antioch	isMarriedTo	Raynald_of_Châtillon
Alexander_I_of_Scotland	hasChild	David_I_of_Scotland
Ferdinand_Marcos	hasChild	Imee_Marcos
Charles_IV,_Holy_Roman_Emperor	hasChild	Wenceslaus_I,_Duke_of_Luxembourg
Clementine_Churchill,_Baroness_Spencer-Churchill	hasChild	Mary_Soames,_Baroness_Soames
Louis_XV_of_France	isMarriedTo	Marie_Leszczyńska
Lucretia_Garfield	isMarriedTo	James_A._Garfield
James_II_of_Aragon	hasChild	Alfonso_IV_of_Aragon
Princess_Karoline_Mathilde_of_Schleswig-Holstein-Sonderburg-Augustenburg	isMarriedTo	Friedrich_Ferdinand,_Duke_of_Schleswig-Holstein
Sirimavo_Bandaranaike	hasChild	Chandrika_Kumaratunga
Catherine_Pavlovna_of_Russia	hasChild	Sophie_of_Württemberg
James_A._Garfield	hasChild	James_Rudolph_Garfield
Fulk,_King_of_Jerusalem	hasChild	Amalric_I_of_Jerusalem
Frederick_I,_Margrave_of_Brandenburg-Ansbach	hasChild	Albert,_Duke_in_Prussia
Clementine_Churchill,_Baroness_Spencer-Churchill	isMarriedTo	Winston_Churchill
Pieter_van_Vollenhoven	isMarriedTo	Princess_Margriet_of_the_Netherlands
Princess_Margaret_of_Connaught	hasChild	Prince_Bertil,_Duke_of_Halland
Robert_II,_Duke_of_Burgundy	hasChild	Joan_the_Lame
Kamehameha_I	hasChild	Kamehameha_II
Sophia_of_Nassau	isMarriedTo	Oscar_II_of_Sweden
Francis_II,_Holy_Roman_Emperor	hasChild	Archduke_Franz_Karl_of_Austria
Lenore_Romney	isMarriedTo	George_W._Romney
Margaret,_Countess_of_Anjou	isMarriedTo	Charles,_Count_of_Valois
Wilhelm_II,_German_Emperor	hasChild	Prince_Eitel_Friedrich_of_Prussia
Margaret_of_Austria,_Queen_of_Spain	isMarriedTo	Philip_III_of_Spain
Tony_Curtis	isMarriedTo	Janet_Leigh
Asif_Ali_Zardari	hasChild	Bilawal_Bhutto_Zardari
William_I_of_the_Netherlands	hasChild	William_II_of_the_Netherlands
Ferdinand_Albert_II,_Duke_of_Brunswick-Wolfenbüttel	hasChild	Princess_Sophie_Antoinette_of_Brunswick-Wolfenbüttel
François_Mitterrand	hasChild	Lionel_Jospin
Leopold_II,_Grand_Duke_of_Tuscany	hasChild	Archduke_Karl_Salvator_of_Austria
Isabella_of_France	isMarriedTo	Edward_II_of_England
Guy_of_Lusignan	hasChild	Conrad_of_Montferrat
Landgravine_Elisabeth_Amalie_of_Hesse-Darmstadt	hasChild	Maria_Sophia_of_Neuburg
Ludwig_III_of_Bavaria	isMarriedTo	Maria_Theresa_of_Austria-Este_(1849–1919)
Agrippina_the_Elder	hasChild	Caligula
Eleanor_of_Portugal,_Holy_Roman_Empress	hasChild	Maximilian_I,_Holy_Roman_Emperor
Frederica_of_Hanover	hasChild	Queen_Sofía_of_Spain
William_Godwin	isMarriedTo	Mary_Wollstonecraft
Hedwig_of_Kalisz	isMarriedTo	Władysław_I_the_Elbow-high
Christian_IX_of_Denmark	hasChild	Princess_Thyra_of_Denmark
Charles_I_of_Hungary	isMarriedTo	Elizabeth_of_Poland,_Queen_of_Hungary
Jacqueline,_Countess_of_Hainaut	isMarriedTo	John,_Dauphin_of_France,_Duke_of_Touraine
Rosalynn_Carter	hasChild	Nancy_Reagan
Queen_Victoria	hasChild	Ernest_Augustus_I_of_Hanover
Baldwin_V,_Count_of_Flanders	isMarriedTo	Adèle_of_France,_Countess_of_Flanders
Naomi_Foner_Gyllenhaal	hasChild	Jake_Gyllenhaal
Fulk,_King_of_Jerusalem	hasChild	Sibylla_of_Anjou
Philip_III_of_Spain	hasChild	Maria_Anna_of_Spain
Conrad_of_Montferrat	isMarriedTo	Isabella_I_of_Jerusalem
Maria_Cristina_of_Savoy	hasChild	Maria_Theresa_of_Austria,_Queen_of_the_Two_Sicilies
Ludwig_I_of_Bavaria	hasChild	Luitpold,_Prince_Regent_of_Bavaria
Wilhelm_II_of_Germany	hasChild	Prince_Oskar_of_Prussia
Archduke_Charles,_Duke_of_Teschen	isMarriedTo	Princess_Henrietta_of_Nassau-Weilburg
Theresa_of_Portugal,_Countess_of_Flanders	hasChild	Marie_of_Champagne
Claude_of_France	isMarriedTo	Francis_I_of_France
Francis_I_of_the_Two_Sicilies	hasChild	Princess_Maria_Antonia_of_the_Two_Sicilies
Ferdinand_I_of_Romania	hasChild	Maria_of_Yugoslavia
Princess_Ludovika_of_Bavaria	hasChild	Empress_Elisabeth_of_Austria
Sigismund,_Holy_Roman_Emperor	hasChild	Albert_II_of_Germany
María_Isabella_of_Spain	hasChild	Maria_Cristina_of_Savoy
Elizabeth_of_Bosnia	hasChild	Margaret_of_Durazzo
Elizabeth_of_Bohemia	hasChild	Charles_I_Louis,_Elector_Palatine
George_V_of_the_United_Kingdom	isMarriedTo	Mary_of_Teck
Princess_Maria_Antonia_of_the_Two_Sicilies	hasChild	Archduke_Karl_Salvator_of_Austria
Lalla_Latifa	isMarriedTo	Hassan_II_of_Morocco
Elizabeth_Stuart,_Queen_of_Bohemia	hasChild	Charles_I_Louis,_Elector_Palatine
Wilhelm_II,_German_Emperor	hasChild	Princess_Victoria_Louise_of_Prussia
James_IV_of_Scotland	hasChild	James_V_of_Scotland
Frederick_William_I_of_Prussia	isMarriedTo	Sophia_Dorothea_of_Hanover
Jeanne_d'Albret	hasChild	Henry_IV_of_France
Wilhelm_I_of_Germany	hasChild	Princess_Louise_of_Prussia
Eleanor_of_Castile	hasChild	Edward_II_of_England
Jane_Seymour	isMarriedTo	Henry_VIII_of_England
Ottokar_II_of_Bohemia	hasChild	Wenceslaus_II_of_Bohemia
Ingrid_of_Sweden	hasChild	Henrik,_Prince_Consort_of_Denmark
Ségolène_Royal	hasChild	Jack_Lang_(French_politician)
Princess_Alexandra_of_Saxe-Altenburg	hasChild	Olga_Constantinovna_of_Russia
Henry_II_of_France	isMarriedTo	Catherine_of_Medici
Isabella_of_Portugal	hasChild	Mary_I_of_England
Augusta_Victoria_of_Schleswig-Holstein	hasChild	Prince_Adalbert_of_Prussia_(1884–1948)
Louise_of_Mecklenburg-Strelitz	hasChild	William_I,_German_Emperor
Charles_XV_of_Sweden	isMarriedTo	Louise_of_the_Netherlands
Victor_Amadeus_I,_Duke_of_Savoy	hasChild	Charles_Emmanuel_II,_Duke_of_Savoy
Charles_III_of_Spain	hasChild	Charles_IV_of_Spain
Sophia_of_Nassau	hasChild	Prince_Oscar_Bernadotte
Mary,_Queen_of_Hungary	isMarriedTo	Jobst_of_Moravia
Dorothea_of_Brandenburg	isMarriedTo	Christian_I_of_Denmark
Philippe_II,_Duke_of_Orléans	hasChild	Louise_Élisabeth_d'Orléans
John_V,_Duke_of_Brittany	hasChild	John_VI,_Duke_of_Brittany
Vic_Morrow	hasChild	Jennifer_Jason_Leigh
Louis,_Dauphin_of_France_(1729–1765)	hasChild	Charles_X_of_France
Philip_V_of_Spain	hasChild	Joseph_I,_Holy_Roman_Emperor
James_I_of_Aragon	isMarriedTo	Violant_of_Hungary
Agnes_of_Germany	hasChild	Henry_II,_Duke_of_Austria
Ted_Kennedy	hasChild	Patrick_J._Kennedy
Honey_Irani	isMarriedTo	Javed_Akhtar
Maria_Alexandrovna_(Marie_of_Hesse)	isMarriedTo	Alexander_II_of_Russia
Princess_Maria_Josepha_of_Saxony_(1731–1767)	isMarriedTo	Louis,_Dauphin_of_France_(1729–1765)
Maria_Luisa_of_Spain	hasChild	Francis_I_of_Austria
Agnes_of_Burgundy,_Duchess_of_Aquitaine	hasChild	Agnes_of_Poitou
Archduke_Karl_Ferdinand_of_Austria	hasChild	Maria_Christina_of_Austria
Sophie_of_Mecklenburg-Güstrow	hasChild	Christian_IV_of_Denmark
Princess_Antoinette_of_Brunswick-Wolfenbüttel	hasChild	Princess_Sophie_Antoinette_of_Brunswick-Wolfenbüttel
Charles_IV,_Holy_Roman_Emperor	hasChild	Sigismund,_Holy_Roman_Emperor
Maria_Carolina_of_Austria	hasChild	Julie_Clary
Violant_of_Hungary	hasChild	Peter_III_of_Aragon
Louis_I_of_Hungary	hasChild	Mary,_Queen_of_Hungary
Joan_of_Navarre,_Queen_of_England	isMarriedTo	John_V,_Duke_of_Brittany
Albert,_Prince_Consort	isMarriedTo	Queen_Victoria
Judith_of_Habsburg	hasChild	Elizabeth_of_Bohemia_(1292–1330)
Ferdinand_VII_of_Spain	hasChild	Isabella_II_of_Spain
John_D._Rockefeller,_Jr.	hasChild	Winthrop_Rockefeller
Ferdinand_Albert_II,_Duke_of_Brunswick-Wolfenbüttel	isMarriedTo	Princess_Antoinette_of_Brunswick-Wolfenbüttel
Maria_Laskarina	hasChild	Stephen_V_of_Hungary
Joachim_Murat	hasChild	Prince_Achille_Murat
Augusta_Victoria_of_Schleswig-Holstein	hasChild	Prince_Oskar_of_Prussia
Kīnaʻu	hasChild	Bernice_Pauahi_Bishop
Louis_II_of_Naples	hasChild	René_of_Anjou
Nicholas_I_of_Montenegro	isMarriedTo	Milena_Vukotić
Iziaslav_I_of_Kiev	hasChild	Vsevolod_I_of_Kiev
Ptolemy_I_Soter	isMarriedTo	Berenice_I_of_Egypt
Princess_Elisabeth_Sophie_of_Saxe-Altenburg	hasChild	Frederick_I,_Duke_of_Saxe-Gotha-Altenburg
Margherita_of_Savoy	isMarriedTo	Umberto_I_of_Italy
Joan_of_Navarre,_Queen_of_England	hasChild	John_VI,_Duke_of_Brittany
Elizabeth_Woodville	hasChild	Anne_Neville
Adelaide_of_Löwenstein-Wertheim-Rosenberg	isMarriedTo	Miguel_I_of_Portugal
Queen_Victoria	hasChild	Princess_Helena_of_the_United_Kingdom
Prince_Bernhard_of_the_Netherlands	hasChild	Beatrix_of_the_Netherlands
Frederick_I,_Holy_Roman_Emperor	isMarriedTo	Beatrice_I,_Countess_of_Burgundy
Erkki_Liikanen	isMarriedTo	Ján_Figeľ
Peter_the_Great	hasChild	Catherine_I_of_Russia
Henry_II,_Duke_of_Austria	isMarriedTo	Gertrude_of_Süpplingenburg
George_W._Romney	hasChild	Mitt_Romney
Philip_II_of_Spain	hasChild	Isabella_Clara_Eugenia
Princess_Augusta_Wilhelmine_of_Hesse-Darmstadt	hasChild	Caroline_Augusta_of_Bavaria
Ottokar_II_of_Bohemia	isMarriedTo	Margaret_of_Austria,_Queen_of_Bohemia
Wenceslaus_I,_Duke_of_Luxembourg	hasChild	Wenceslaus_IV_of_Bohemia
Jacques_Chirac	hasChild	Michel_Rocard
Luís_I_of_Portugal	isMarriedTo	Maria_Pia_of_Savoy
Prince_Ferdinand_Philippe,_Duke_of_Orléans	hasChild	Prince_Philippe,_Count_of_Paris
Elizabeth_of_Luxembourg	hasChild	Elisabeth_of_Habsburg_(1436–1505)
Frederick_III,_Holy_Roman_Emperor	hasChild	Maximilian_I,_Holy_Roman_Emperor
Władysław_II_the_Exile	hasChild	Mieszko_IV_Tanglefoot
Caroline_Augusta_of_Bavaria	isMarriedTo	William_I_of_Württemberg
Margaret_I,_Countess_of_Flanders	hasChild	Henry_of_Flanders
Albert_II_of_Germany	hasChild	Elisabeth_of_Habsburg_(1436–1505)
Keōpūolani	hasChild	Kamehameha_III
Lucretia_Garfield	hasChild	James_Rudolph_Garfield
Ferdinand_Marcos	hasChild	Corazon_Aquino
Winston_Churchill	hasChild	Clement_Attlee
Wilhelm_II_of_Germany	hasChild	Prince_Joachim_of_Prussia
Shah_Jahan	hasChild	Aurangzeb
Louise_of_Orléans	hasChild	Prince_Philippe,_Count_of_Flanders
Isabella_of_Austria	hasChild	Christina_of_Denmark
Gisela_of_Swabia	hasChild	Agnes_of_Poitou
Wu_Zetian	isMarriedTo	Emperor_Gaozong_of_Tang
Duke_Maximilian_Joseph_in_Bavaria	hasChild	Empress_Elisabeth_of_Austria
Wilhelm_II,_German_Emperor	hasChild	Prince_Adalbert_of_Prussia_(1884–1948)
Matilda_of_Scotland	hasChild	Empress_Matilda
Abby_Aldrich_Rockefeller	hasChild	John_D._Rockefeller_III
Martha_Washington	hasChild	John_Parke_Custis
Emma_of_Normandy	isMarriedTo	Canute
Chiang_Kai-shek	isMarriedTo	Soong_May-ling
Alexandra_Feodorovna_(Charlotte_of_Prussia)	hasChild	Grand_Duke_Konstantin_Nikolayevich_of_Russia
Yolande_of_Aragon	isMarriedTo	Louis_II_of_Naples
Eddie_Albert	hasChild	Edward_Albert
Maria_Josepha_of_Saxony,_Dauphine_of_France	hasChild	Louis_XVIII_of_France
Friedrich_III_of_Germany	hasChild	Sophia_of_Prussia
Francis_I,_Holy_Roman_Emperor	hasChild	Joseph_II,_Holy_Roman_Emperor
Leopold_II,_Holy_Roman_Emperor	isMarriedTo	Maria_Luisa_of_Spain
Ferdinand_I_of_Romania	hasChild	Carol_II_of_Romania
Isabella_I_of_Jerusalem	isMarriedTo	Henry_II,_Count_of_Champagne
Maximilian_II,_Holy_Roman_Emperor	hasChild	Elisabeth_of_Austria,_Queen_of_France
Judith_of_Habsburg	hasChild	Wenceslaus_III_of_Bohemia
Elizabeth_of_Pomerania	hasChild	Sigismund,_Holy_Roman_Emperor
Eleanor_of_Provence	hasChild	Isabella_of_France
Princess_Marie_Isabelle_of_Orléans	hasChild	Princess_Louise_of_Orléans
Stephen_Gyllenhaal	hasChild	Jake_Gyllenhaal
Anthony,_Duke_of_Brabant	hasChild	Philip_I,_Duke_of_Brabant
Mark_Antony	hasChild	Ptolemy_II_Philadelphus
William_I_of_Sicily	isMarriedTo	Roger_II_of_Sicily
Umberto_I_of_Italy	hasChild	Vittorio_Emanuele_III
Wilhelmine_Amalia_of_Brunswick-Lüneburg	hasChild	Maria_Amalia_of_Austria
Charles_IV_of_Spain	isMarriedTo	Maria_Luisa_of_Parma
Isabella_of_France	hasChild	Catherine_of_Valois
Francisco_da_Costa_Gomes	hasChild	António_Ramalho_Eanes
Charles_I_of_Hungary	hasChild	Louis_I_of_Hungary
Napoleon	isMarriedTo	Marie_Louise,_Duchess_of_Parma
Isabella_of_Valois	hasChild	Joan_of_Navarre,_Queen_of_England
Eugène_de_Beauharnais	hasChild	Josephine_of_Leuchtenberg
Wilhelm_II_of_Germany	hasChild	Prince_August_Wilhelm_of_Prussia
Polemon_I_of_Pontus	hasChild	Pythodorida_of_Pontus
Isabella_of_Clermont	isMarriedTo	Ferdinand_I_of_Naples
Dorothea_of_Saxe-Lauenburg	isMarriedTo	Christian_III_of_Denmark
Francis_I_of_the_Two_Sicilies	hasChild	Teresa_Cristina_of_the_Two_Sicilies
Charles_III,_Duke_of_Lorraine	hasChild	Margaret_of_Valois
Margaret_Tudor	hasChild	James_V_of_Scotland
Elisabeth_of_Valois	isMarriedTo	Philip_II_of_Spain
Maria_Anna_of_Spain	hasChild	Mariana_of_Austria
Philip_I_of_Castile	hasChild	Eleanor_of_Austria
Princess_Märtha_of_Sweden	isMarriedTo	Olav_V_of_Norway
Jean-Louis_Borloo	hasChild	Nathalie_Kosciusko-Morizet
Ferdinand_III,_Holy_Roman_Emperor	isMarriedTo	Eleonora_Gonzaga_(1630–1686)
Francis_I,_Holy_Roman_Emperor	hasChild	Maria_Carolina_of_Austria
Marie_of_Brabant,_Queen_of_France	hasChild	Margaret_of_France,_Queen_of_England
Margaret_Tudor	isMarriedTo	James_IV_of_Scotland
Wilhelmine_Amalia_of_Brunswick-Lüneburg	hasChild	Maria_Josepha_of_Austria
Ernest_Augustus,_Duke_of_Brunswick	isMarriedTo	Princess_Victoria_Louise_of_Prussia
Emperor_Taizong_of_Tang	isMarriedTo	Wu_Zetian
Carlo_Buonaparte	hasChild	Joseph_Bonaparte
Anne_of_Austria	isMarriedTo	Louis_XIII_of_France
Gustav_I_of_Sweden	hasChild	Charles_IX_of_Sweden
Philip_IV_of_Spain	hasChild	John_IV_of_Portugal
Princess_Elisabeth_Sophie_of_Saxe-Altenburg	hasChild	Bernhard_I,_Duke_of_Saxe-Meiningen
Juan_Carlos_I_of_Spain	isMarriedTo	Queen_Sofía_of_Spain
Sigismund,_Holy_Roman_Emperor	hasChild	Elisabeth,_Duchess_of_Luxembourg
fr/Silvano_Ribeiro	hasChild	José_Baptista_Pinheiro_de_Azevedo
Bretislaus_I,_Duke_of_Bohemia	isMarriedTo	Judith_of_Schweinfurt
Agnes_of_Germany	hasChild	Conrad_III_of_Germany
Isabella_of_Castile	hasChild	Joanna_of_Castile
María_Isabella_of_Spain	hasChild	Ferdinand_II_of_the_Two_Sicilies
Amalia_of_Oldenburg	isMarriedTo	Otto,_King_of_Greece
Mary_of_Hungary,_Queen_of_Naples	isMarriedTo	Charles_II_of_Naples
Joan,_Countess_of_Flanders	hasChild	Margaret_II,_Countess_of_Flanders
Philip_II_of_France	hasChild	Philip_I,_Count_of_Boulogne
Henry_IV_of_France	isMarriedTo	Marie_de'_Medici
Gordon_Brown	hasChild	Ed_Miliband
Mark_Warner	isMarriedTo	Tim_Kaine
Juliana_of_the_Netherlands	hasChild	Princess_Margriet_of_the_Netherlands
Constantine_I_of_Greece	hasChild	Alexander_of_Greece
Louise_Élisabeth_of_France	hasChild	Archduchess_Maria_Amalia_of_Austria
Isabelle_of_Hainaut	isMarriedTo	Philip_II_of_France
Charles_IV,_Holy_Roman_Emperor	isMarriedTo	Elizabeth_of_Pomerania
Ivan_V_of_Russia	hasChild	Anna_of_Russia
Joanna_Shimkus	hasChild	Sydney_Tamiia_Poitier
Princess_Maria_Josepha_of_Saxony_(1731–1767)	hasChild	Louis_XVI_of_France
Sophia_Dorothea_of_Hanover	hasChild	Louisa_Ulrika_of_Prussia
Jaya_Bachchan	isMarriedTo	Amitabh_Bachchan
Princess_Maria_Annunciata_of_Bourbon-Two_Sicilies	isMarriedTo	Archduke_Karl_Ludwig_of_Austria
Ernest_Augustus,_Elector_of_Brunswick-Lüneburg	isMarriedTo	Sophia_of_Hanover
Jacqueline_Kennedy_Onassis	hasChild	Caroline_Kennedy
Bernadette_Chirac	isMarriedTo	Jacques_Chirac
Jacques_Chirac	isMarriedTo	Bernadette_Chirac
Debbie_Reynolds	isMarriedTo	Eddie_Fisher_(singer)
Louis_XIII_of_France	hasChild	Philippe_I,_Duke_of_Orléans
Maximilian_II,_Holy_Roman_Emperor	hasChild	Albert_VII,_Archduke_of_Austria
Jean-Louis_Borloo	hasChild	Christine_Lagarde
Henry_V_of_England	isMarriedTo	Catherine_of_Valois
Blanche_of_Anjou	hasChild	Alfonso_IV_of_Aragon
Louise_of_Hesse-Kassel	hasChild	George_I_of_Greece
Eleanor_of_Toledo	hasChild	Ferdinando_I_de'_Medici,_Grand_Duke_of_Tuscany
Diane_Cilento	hasChild	Jason_Connery
Frederick_Augustus_III_of_Saxony	hasChild	Friedrich_Christian,_Margrave_of_Meissen
George_III_of_the_United_Kingdom	isMarriedTo	Charlotte_of_Mecklenburg-Strelitz
Agrippina_the_Elder	isMarriedTo	Germanicus
Yaroslav_the_Wise	isMarriedTo	Olof_Skötkonung
Henry_I_of_England	isMarriedTo	Alexander_I_of_Scotland
Sophia_of_Nassau	hasChild	Gustaf_V_of_Sweden
Nargis	hasChild	Sanjay_Dutt
Albert_VII,_Archduke_of_Austria	isMarriedTo	Isabella_Clara_Eugenia
Philippa_of_Hainault	isMarriedTo	Edward_III_of_England
Edward,_King_of_Portugal	isMarriedTo	Eleanor_of_Aragon,_Queen_of_Portugal
Elisabeth_of_Swabia	hasChild	Henry_of_Castile_the_Senator
Ferdinand_I_of_Romania	hasChild	Prince_Nicholas_of_Romania
Frederick_I,_Holy_Roman_Emperor	hasChild	Henry_VI,_Holy_Roman_Emperor
Virginia_Fox	hasChild	Richard_D._Zanuck
James_A._Garfield	isMarriedTo	Lucretia_Garfield
Maria_Theresa_of_Austria,_Queen_of_the_Two_Sicilies	hasChild	Prince_Alfonso,_Count_of_Caserta
Charles_III,_Duke_of_Parma	hasChild	Robert_I,_Duke_of_Parma
Henry_II_of_France	hasChild	Elisabeth_of_Valois
Harry_Payne_Whitney	isMarriedTo	Gertrude_Vanderbilt_Whitney
Mary_of_Teck	hasChild	Edward_VIII_of_the_United_Kingdom
Edward_III_of_England	hasChild	Richard_II_of_England
Margaret_of_France,_Queen_of_England	hasChild	Isabella_of_France
Bona_Sforza	hasChild	Catherine_Jagiellon
Saint_Margaret_of_Scotland	hasChild	Matilda_of_Scotland
Sophia_Charlotte_of_Hanover	hasChild	Frederick_William_I_of_Prussia
Eleanor_of_Austria	isMarriedTo	Manuel_I_of_Portugal
Anne_of_Brittany	isMarriedTo	Charles_VIII_of_France
Francis_I_of_France	hasChild	Henry_II_of_France
Isabella_of_Portugal,_Duchess_of_Burgundy	hasChild	Charles_the_Bold
Infanta_Maria_Anna_of_Portugal_(1843–1884)	isMarriedTo	George,_King_of_Saxony
Marie_Henriette_of_Austria	hasChild	Elisabeth_of_Bavaria,_Queen_of_Belgium
Princess_Sophie_of_Bavaria	hasChild	Franz_Joseph_I_of_Austria
James_I_of_Aragon	hasChild	Isabella_of_Aragon
Kekūanāoa	hasChild	Bernice_Pauahi_Bishop
Caroline_Bonaparte	isMarriedTo	Joachim_Murat
Anne_Catherine_of_Brandenburg	hasChild	Sophie_Amalie_of_Brunswick-Lüneburg
Eleanor_of_Castile	hasChild	Margaret_of_France,_Queen_of_England
Francis,_Duke_of_Cádiz	isMarriedTo	Isabella_II_of_Spain
Letizia_Ramolino	hasChild	Caroline_Bonaparte
Jacques_Chirac	hasChild	Jean_Tiberi
Catherine_de'_Medici	isMarriedTo	Henry_II_of_France
Elisabeth_of_Bavaria,_Queen_of_Germany	hasChild	Henry_of_Bohemia
Maggie_Smith	isMarriedTo	Robert_Stephens
Edward_VII_of_the_United_Kingdom	isMarriedTo	Alexandra_of_Denmark
Albert_VII,_Archduke_of_Austria	hasChild	Elisabeth_of_France_(1602–1644)
Joan_II_of_Navarre	hasChild	Charles_II_of_Navarre
Margaret_of_Austria,_Queen_of_Spain	hasChild	Anne_of_Austria
Marie_Curie	isMarriedTo	Pierre_Curie
Giovanna_of_Italy	hasChild	Simeon_Saxe-Coburg-Gotha
Prince_Alfonso,_Count_of_Caserta	isMarriedTo	Princess_Maria_Antonietta_of_Bourbon-Two_Sicilies
Princess_Margriet_of_the_Netherlands	hasChild	Prince_Bernhard_of_Orange-Nassau,_van_Vollenhoven
Sigismund_III_Vasa	isMarriedTo	Anne_of_Austria,_Queen_of_Poland
Louise_Élisabeth_of_France	isMarriedTo	Philip,_Duke_of_Parma
Barbara_Bush	hasChild	George_W._Bush
Eleonora_Gonzaga_(1630–1686)	hasChild	Margaret_Theresa_of_Spain
Charles_XV_of_Sweden	hasChild	Louise_of_Sweden
Eugène_de_Beauharnais	hasChild	Maximilian_de_Beauharnais,_3rd_Duke_of_Leuchtenberg
Christian_IX_of_Denmark	hasChild	Frederick_VIII_of_Denmark
F._W._de_Klerk	hasChild	Thabo_Mbeki
Philip_IV_of_France	hasChild	Philip_V_of_France
Isabeau_of_Bavaria	hasChild	Isabella_of_Valois
Dorothea_Maria_of_Anhalt	isMarriedTo	John_II,_Duke_of_Saxe-Weimar
Constance_of_Aragon	isMarriedTo	Frederick_II,_Holy_Roman_Emperor
John_Cromwell_(director)	isMarriedTo	Kay_Johnson
Elisabeth_of_Habsburg_(1436–1505)	hasChild	Sigismund_I_the_Old
William_I_of_the_Netherlands	isMarriedTo	Wilhelmine_of_Prussia,_Queen_of_the_Netherlands
Henry_VI,_Holy_Roman_Emperor	isMarriedTo	Constance,_Queen_of_Sicily
Ralph_de_Neville,_1st_Earl_of_Westmorland	hasChild	Cecily_Neville,_Duchess_of_York
Eleanor_of_Naples,_Duchess_of_Ferrara	isMarriedTo	Ercole_I_d'Este,_Duke_of_Ferrara
Gustaf_VI_Adolf_of_Sweden	hasChild	Ingrid_of_Sweden
Elisabeth_of_Swabia	isMarriedTo	Ferdinand_III_of_Castile
John_Barrymore	hasChild	John_Drew_Barrymore
Louis_XIV_of_France	hasChild	Philippe,_Duke_of_Orléans
Bolesław_III_Wrymouth	hasChild	Bolesław_IV_the_Curly
Beatrice_of_Savoy	hasChild	Eleanor_of_Provence
Olga_Feodorovna_of_Baden	hasChild	Grand_Duke_Alexei_Mikhailovich_of_Russia
Demetrius_II_Nicator	hasChild	Antiochus_VIII_Grypus
Ferdinand,_Duke_of_Breisgau	hasChild	Francis_IV,_Duke_of_Modena
Maria_Anna_of_Bavaria_(1551–1608)	hasChild	Margaret_of_Austria,_Queen_of_Spain
Carlo_Buonaparte	hasChild	Elisa_Bonaparte
Thomas_I,_Count_of_Savoy	isMarriedTo	Margaret_of_Geneva
Carlota_Joaquina_of_Spain	hasChild	Pedro_I_of_Brazil
Maria_Theresa_of_Austria-Este,_Queen_of_Sardinia	isMarriedTo	Victor_Emmanuel_I_of_Sardinia
Queen_Victoria	hasChild	Victoria,_Princess_Royal
Bonne_of_Artois	isMarriedTo	Philip_the_Good
Charlotte_of_Savoy	hasChild	Anne_of_Brittany
Archduke_Karl_Ferdinand_of_Austria	hasChild	Archduke_Eugen_of_Austria
James_I_of_Scotland	hasChild	James_II_of_Scotland
Charles_II,_Archduke_of_Austria	hasChild	Anne_of_Austria,_Queen_of_Poland
Olga_Constantinovna_of_Russia	hasChild	Constantine_I_of_Greece
Philip_V_of_Spain	hasChild	Philip,_Duke_of_Parma
Louis_IX_of_France	hasChild	Agnes_of_France,_Duchess_of_Burgundy
Bhumibol_Adulyadej	hasChild	Vajiralongkorn
Ingegerd_Olofsdotter_of_Sweden	hasChild	Sviatoslav_II_of_Kiev
Elizabeth_Richeza_of_Poland	isMarriedTo	Wenceslaus_II_of_Bohemia
Sweyn_Forkbeard	isMarriedTo	Sigrid_the_Haughty
Elizabeth_Woodville	isMarriedTo	Edward_IV_of_England
Władysław_I_the_Elbow-high	hasChild	Wenceslaus_II_of_Bohemia
Caroline_Augusta_of_Bavaria	hasChild	Maria_Anna_of_Savoy
Ferdinand_III,_Holy_Roman_Emperor	hasChild	Mariana_of_Austria
Charlotte_of_Mecklenburg-Strelitz	hasChild	William_IV_of_the_United_Kingdom
Maria_Cristina_of_Savoy	isMarriedTo	Ferdinand_II_of_the_Two_Sicilies
Giovanna_of_Italy	isMarriedTo	Boris_III_of_Bulgaria
Princess_Alexandra_of_Saxe-Altenburg	hasChild	Grand_Duke_Konstantin_Konstantinovich_of_Russia
Richard_I_of_England	isMarriedTo	Eleanor_of_Aquitaine
Ronald_Reagan	hasChild	George_H._W._Bush
Frederick_II_of_Denmark	hasChild	Christian_IV_of_Denmark
Olga_Feodorovna_of_Baden	hasChild	Grand_Duke_Alexander_Mikhailovich_of_Russia
George_H._W._Bush	hasChild	Jeb_Bush
Charles_VII_of_France	hasChild	Louis_XI_of_France
Maria_Luisa_of_Savoy	isMarriedTo	Philip_V_of_Spain
John_V_of_Portugal	isMarriedTo	Maria_Anna_of_Austria
Frederick_III_of_Denmark	isMarriedTo	Sophie_Amalie_of_Brunswick-Lüneburg
Eleanor_of_England,_Queen_of_Castile	hasChild	Urraca_of_Castile,_Queen_of_Portugal
Nusrat_Bhutto	isMarriedTo	Zulfikar_Ali_Bhutto
Archduchess_Elisabeth_Franziska_of_Austria	isMarriedTo	Archduke_Ferdinand_Karl_Viktor_of_Austria-Este
Barbara_Hale	isMarriedTo	Bill_Williams_(actor)
Christian_IV_of_Denmark	isMarriedTo	Anne_Catherine_of_Brandenburg
Archduke_Franz_Karl_of_Austria	hasChild	Archduke_Karl_Ludwig_of_Austria
Ferdinand_II_of_Aragon	isMarriedTo	Isabella_of_Castile
Sarah_Jane_Brown	hasChild	Samantha_Cameron
Augusta_of_Saxe-Weimar-Eisenach	isMarriedTo	Wilhelm_I_of_Germany
Margaret_III,_Countess_of_Flanders	hasChild	John_the_Fearless
Philip_the_Bold	hasChild	Anthony,_Duke_of_Brabant
Maria_Feodorovna_(Sophie_Dorothea_of_Württemberg)	hasChild	Grand_Duke_Michael_Pavlovich_of_Russia
Mary_of_Guise	hasChild	Mary,_Queen_of_Scots
Lady_Bird_Johnson	hasChild	Pat_Nixon
Adelaide_of_Maurienne	hasChild	Louis_VII_of_France
Babita	isMarriedTo	Randhir_Kapoor
Saint_Margaret_of_Scotland	hasChild	Duncan_II_of_Scotland
Marie_Casimire_Louise_de_La_Grange_d'Arquien	hasChild	James_Louis_Sobieski
Sweyn_I_of_Denmark	isMarriedTo	Sigrid_the_Haughty
Anne_Catherine_of_Brandenburg	hasChild	Frederick_III_of_Denmark
Dalia_Grybauskaitė	hasChild	Ján_Figeľ
Frederick_IX_of_Denmark	isMarriedTo	Ingrid_of_Sweden
Beatrice_of_Provence	hasChild	Charles_II_of_Naples
Robert_Stephens	hasChild	Toby_Stephens
Sigismund,_Holy_Roman_Emperor	hasChild	Elizabeth_of_Luxembourg
John_of_Bohemia	isMarriedTo	Elizabeth_of_Bohemia_(1292–1330)
Judith_of_Swabia	hasChild	Salomea_of_Berg
Adelaide_of_Meissen	isMarriedTo	Ottokar_I_of_Bohemia
Amalric_I_of_Jerusalem	isMarriedTo	Agnes_of_Courtenay
Caroline_of_Baden	hasChild	Therese_of_Saxe-Hildburghausen
Louise_Élisabeth_of_France	hasChild	Ferdinand,_Duke_of_Parma
Bertha_of_Holland	hasChild	Constance_of_France,_Princess_of_Antioch
Malcolm_III_of_Scotland	hasChild	Matilda_of_Scotland
Margaret_of_Austria,_Queen_of_Spain	hasChild	Elisabeth_of_France_(1602–1644)
Victoria_of_Baden	isMarriedTo	Gustaf_V_of_Sweden
Princess_Augusta_of_Bavaria	hasChild	Amélie_of_Leuchtenberg
Casimir_I_the_Restorer	hasChild	Władysław_I_Herman
Francis,_Duke_of_Cádiz	hasChild	Alfonso_XII_of_Spain
Marie_Louise,_Duchess_of_Parma	hasChild	Charles_II,_Duke_of_Parma
Bertrade_de_Montfort	hasChild	Fulk,_King_of_Jerusalem
Victoria,_Princess_Royal	hasChild	Prince_Henry_of_Prussia_(1862–1929)
Paul_I_of_Russia	hasChild	Catherine_Pavlovna_of_Russia
Luisa_de_Guzmán	isMarriedTo	John_IV_of_Portugal
Sophia_Jagiellon,_Margravine_of_Brandenburg-Ansbach	isMarriedTo	Frederick_I,_Margrave_of_Brandenburg-Ansbach
Kamehameha_II	isMarriedTo	Kīnaʻu
Prince_Bernhard_of_Lippe-Biesterfeld	hasChild	Beatrix_of_the_Netherlands
Charles_V,_Holy_Roman_Emperor	isMarriedTo	Isabella_of_Portugal
Jacqueline,_Countess_of_Hainaut	hasChild	Philip_the_Good
Sidney_Poitier	isMarriedTo	Joanna_Shimkus
Ronald_Reagan	hasChild	Jerry_Brown
Duchess_Helene_of_Mecklenburg-Schwerin	isMarriedTo	Prince_Ferdinand_Philippe,_Duke_of_Orléans
Jack_Cassidy	hasChild	David_Cassidy
Afonso_I_of_Portugal	hasChild	Theresa_of_Portugal,_Countess_of_Flanders
Shirley_Jones	isMarriedTo	Jack_Cassidy
Cosimo_I_de'_Medici,_Grand_Duke_of_Tuscany	isMarriedTo	Eleanor_of_Toledo
Richard_of_York,_3rd_Duke_of_York	isMarriedTo	Cecily_Neville,_Duchess_of_York
Mark_Antony	isMarriedTo	Cleopatra
Joanna_of_Castile	isMarriedTo	Charles_V,_Holy_Roman_Emperor
Philip_I,_Duke_of_Brabant	hasChild	Philip_the_Good
Frederick_III,_Holy_Roman_Emperor	hasChild	Kunigunde_of_Austria
Joan_I,_Countess_of_Auvergne	isMarriedTo	John_II_of_France
Anna_of_Austria,_Queen_of_Spain	isMarriedTo	Philip_II_of_Spain
Maria_Luisa_of_Spain	hasChild	Archduke_Charles,_Duke_of_Teschen
Charles_Brandon,_1st_Duke_of_Suffolk	hasChild	Frances_Grey,_Duchess_of_Suffolk
Charles_Emmanuel_I,_Duke_of_Savoy	isMarriedTo	Infanta_Catherine_Michelle_of_Spain
Joan_Bennett_Kennedy	isMarriedTo	Ted_Kennedy
Joseph_I,_Holy_Roman_Emperor	hasChild	Maria_Josepha_of_Austria
Richard_Harris	hasChild	Jared_Harris
Elena_of_Montenegro	hasChild	Marie_José_of_Belgium
Supriya_Pathak	hasChild	Shahid_Kapoor
Elisabeth_Farnese	hasChild	Philip,_Duke_of_Parma
George_III_of_the_United_Kingdom	hasChild	George_IV_of_the_United_Kingdom
Victoria,_Princess_Royal	hasChild	Princess_Margaret_of_Prussia
Pat_Nixon	isMarriedTo	Richard_Nixon
Louise_Élisabeth_d'Orléans	hasChild	Elisabetta_Farnese
Ramon_Berenguer_IV,_Count_of_Provence	isMarriedTo	Beatrice_of_Savoy
Augusta_of_Saxe-Weimar-Eisenach	isMarriedTo	William_I,_German_Emperor
Joséphine_de_Beauharnais	hasChild	Hortense_de_Beauharnais
Eleanor_of_Aquitaine	hasChild	John,_King_of_England
Prince_Claus_of_the_Netherlands	isMarriedTo	Beatrix_of_the_Netherlands
Louis_VIII_of_France	hasChild	Saint_Louis_IX_of_France
Tony_Richardson	hasChild	Joely_Richardson
Laura_Bush	hasChild	Jenna_Bush_Hager
Tony_Blair	hasChild	Gordon_Brown
Charles_II,_Duke_of_Parma	isMarriedTo	Princess_Maria_Teresa_of_Savoy
Princess_Victoria_Louise_of_Prussia	hasChild	Frederica_of_Hanover
Ferdinand_II_of_the_Two_Sicilies	isMarriedTo	Maria_Theresa_of_Austria_(1816–1867)
Philip_II_of_Spain	hasChild	Infanta_Catherine_Michelle_of_Spain
Charles_II_of_Navarre	isMarriedTo	Joan_of_Valois,_Queen_of_Navarre
Louis_XV_of_France	hasChild	Philippe,_Duke_of_Orléans,_Regent_of_France
Marie_Leszczyńska	hasChild	Louise_Élisabeth_of_France
Béla_III_of_Hungary	hasChild	Andrew_II_of_Hungary
Sophia_of_Hanover	isMarriedTo	Ernest_Augustus,_Elector_of_Brunswick-Lüneburg
Richard_of_York,_3rd_Duke_of_York	hasChild	Edward_IV_of_England
Fulk,_King_of_Jerusalem	isMarriedTo	Melisende,_Queen_of_Jerusalem
Gustaf_V_of_Sweden	hasChild	Gustaf_VI_Adolf_of_Sweden
Empress_Teimei	isMarriedTo	Emperor_Taishō
Francis_I_of_Austria	isMarriedTo	Caroline_Augusta_of_Bavaria
Charles_IV_of_Spain	hasChild	Ferdinand_VII_of_Spain
Maria_Theresa	hasChild	Marie_Antoinette
Christopher_of_Bavaria	hasChild	Christian_I_of_Denmark
Joanna_II_of_Naples	isMarriedTo	James_II,_Count_of_La_Marche
Hassa_bint_Ahmed_Al_Sudairi	hasChild	Sultan_bin_Abdulaziz
Élisabeth_Charlotte_d'Orléans	hasChild	Francis_I,_Holy_Roman_Emperor
Adela_of_France,_Countess_of_Flanders	hasChild	Richilde,_Countess_of_Hainaut
Mary_of_Burgundy	isMarriedTo	Maximilian_I,_Holy_Roman_Emperor
Maria_Anna_of_Spain	hasChild	Leopold_I,_Holy_Roman_Emperor
Philip_III_of_France	hasChild	Charles,_Count_of_Valois
Letizia_Ramolino	hasChild	Pauline_Bonaparte
Vittorio_Emanuele_III	isMarriedTo	Elena_of_Montenegro
Princess_Victoria_Louise_of_Prussia	hasChild	Prince_Ernest_Augustus_of_Hanover_(1914–1987)
Anne_of_Brittany	hasChild	Isabella_of_Castile
Beatrice_of_Provence	isMarriedTo	Charles_I_of_Naples
Louis_XII_of_France	hasChild	Ferdinand_II_of_Aragon
Demetrius_II_Nicator	hasChild	Cleopatra_Thea
Manuel_I_of_Portugal	isMarriedTo	Maria_of_Aragon,_Queen_of_Portugal
Bill_Williams_(actor)	hasChild	William_Katt
Victor_Emmanuel_I_of_Sardinia	hasChild	Maria_Cristina_of_Savoy
Judith_of_Schweinfurt	hasChild	Vratislaus_II_of_Bohemia
Elizabeth_Woodville	hasChild	Henrietta_Maria_of_France
Elizabeth_of_Pomerania	isMarriedTo	Charles_IV,_Holy_Roman_Emperor
Jimmy_Carter	hasChild	Ronald_Reagan
Ercole_I_d'Este,_Duke_of_Ferrara	isMarriedTo	Eleanor_of_Naples,_Duchess_of_Ferrara
Maria_Theresa	hasChild	Leopold_II,_Holy_Roman_Emperor
Cleopatra	isMarriedTo	Mark_Antony
Alexandra_of_Denmark	isMarriedTo	Edward_VII_of_the_United_Kingdom
Isabella_of_Castile	isMarriedTo	Ferdinand_II_of_Aragon
Beatrice_I,_Countess_of_Burgundy	hasChild	Philip_of_Swabia
Philippe_II,_Duke_of_Orléans	isMarriedTo	Françoise_Marie_de_Bourbon
Calvin_Coolidge	hasChild	Herbert_Hoover
Yaroslav_the_Wise	isMarriedTo	Ingegerd_Olofsdotter_of_Sweden
Francis_I,_Holy_Roman_Emperor	hasChild	Ferdinand,_Duke_of_Breisgau
Prince_Friedrich_Karl_of_Prussia_(1828–1885)	hasChild	Prince_Friedrich_Leopold_of_Prussia
Sigismund_I_the_Old	hasChild	Hedwig_Jagiellon,_Electress_of_Brandenburg
Ryan_O'Neal	hasChild	Tatum_O'Neal
Henry_II_of_France	hasChild	Margaret_of_Valois
Corazon_Aquino	hasChild	Fidel_V._Ramos
Princess_Sophie_of_Bavaria	hasChild	Archduke_Karl_Ludwig_of_Austria
Maria_Theresa_of_Austria	hasChild	Maria_Carolina_of_Austria
Henry_II,_Count_of_Champagne	isMarriedTo	Isabella_I_of_Jerusalem
Gustaf_VI_Adolf_of_Sweden	hasChild	Prince_Bertil,_Duke_of_Halland
Frederick_III,_Holy_Roman_Emperor	hasChild	Matthias_Corvinus
Princess_Augusta_of_Great_Britain	isMarriedTo	Charles_William_Ferdinand,_Duke_of_Brunswick-Wolfenbüttel
Mark_Warner	hasChild	Tim_Kaine
Henry_IV_of_France	hasChild	Louis_XIII_of_France
Wenceslaus_II_of_Bohemia	hasChild	Władysław_I_the_Elbow-high
Henry_IV_of_France	hasChild	Christine_Marie_of_France
Frederick_William_I_of_Prussia	hasChild	Frederick_the_Great
Mary_of_Hungary,_Queen_of_Naples	hasChild	Margaret,_Countess_of_Anjou
Princess_Isabelle_of_Orléans_(1878–1961)	hasChild	Henri,_Count_of_Paris
Frederick_William_II_of_Prussia	hasChild	Prince_Charles_of_Prussia
John_II_of_Aragon	hasChild	Ferdinand_II_of_Aragon
Władysław_II_the_Exile	hasChild	Bolesław_IV_the_Curly
Edward_VII_of_the_United_Kingdom	hasChild	George_V_of_the_United_Kingdom
Luisa_de_Guzmán	hasChild	Peter_II_of_Portugal
Edward_III_of_England	hasChild	Edmund_of_Langley,_1st_Duke_of_York
Richard_II_of_England	hasChild	Henry_V_of_England
John_of_England	hasChild	Richard,_1st_Earl_of_Cornwall
Princess_Margaret_of_Connaught	isMarriedTo	Gustaf_VI_Adolf_of_Sweden
Isabella_II_of_Spain	hasChild	Amadeo_I_of_Spain
Sharon_Osbourne	hasChild	Kelly_Osbourne
Philip_IV_of_Spain	isMarriedTo	Mariana_of_Austria
Victor_Emmanuel_I_of_Sardinia	hasChild	Maria_Beatrice_of_Savoy
Bonne_of_Artois	hasChild	Isabella_of_Portugal,_Duchess_of_Burgundy
Władysław_I_the_Elbow-high	hasChild	Casimir_III_of_Poland
Princess_Ingeborg_of_Denmark	hasChild	Astrid_of_Sweden
F._W._de_Klerk	isMarriedTo	Thabo_Mbeki
Francis_I_of_the_Two_Sicilies	hasChild	Maria_Christina_of_the_Two_Sicilies
Lothar_Bisky	isMarriedTo	Oskar_Lafontaine
Kamehameha_I	isMarriedTo	Kalākua_Kaheiheimālie
Eleanor_Roosevelt	hasChild	Franklin_Delano_Roosevelt,_Jr.
Philip_III_of_Navarre	isMarriedTo	Joan_II_of_Navarre
Princess_Henriette_Adelaide_of_Savoy	hasChild	Maximilian_II_Emanuel,_Elector_of_Bavaria
Anne_of_Cyprus	hasChild	Margaret_of_Savoy,_Countess_of_Saint-Pol
Mamie_Eisenhower	hasChild	Jacqueline_Kennedy_Onassis
Philip_III_of_France	hasChild	Margaret_of_France,_Queen_of_England
Anne_of_Kiev	isMarriedTo	Henry_I_of_France
Ferdinand_II_of_the_Two_Sicilies	hasChild	Prince_Alfonso,_Count_of_Caserta
John_Adams	hasChild	John_Quincy_Adams
Henry_IV_of_England	isMarriedTo	Mary_de_Bohun
François_Mitterrand	hasChild	Maurice_Bourgès-Maunoury
Eddie_Albert	isMarriedTo	Margo_(actress)
Judith_of_Schweinfurt	isMarriedTo	Bretislaus_I,_Duke_of_Bohemia
Ibn_Saud	hasChild	Salman_bin_Abdulaziz_Al_Saud
Sophia_of_Hanover	hasChild	George_I_of_Great_Britain
Philippe,_Duke_of_Orléans,_Regent_of_France	hasChild	Louise_Élisabeth_d'Orléans
Frederick_William_III_of_Prussia	hasChild	Prince_Albert_of_Prussia_(1809–1872)
Gustaf_V_of_Sweden	hasChild	Prince_Wilhelm,_Duke_of_Södermanland
Richard_II_of_England	hasChild	Henry_IV_of_England
Queen_Paola_of_Belgium	hasChild	Prince_Laurent_of_Belgium
Sigrid_the_Haughty	isMarriedTo	Sweyn_I_of_Denmark
Princess_Victoria_Louise_of_Prussia	isMarriedTo	Ernest_Augustus,_Duke_of_Brunswick
Isabella_of_Portugal	hasChild	Philip_II_of_Spain
Ferdinand_II_of_Aragon	hasChild	Charles_V,_Holy_Roman_Emperor
Marie_of_Romania	isMarriedTo	Ferdinand_I_of_Romania
Sancho_I_of_Portugal	hasChild	Afonso_II_of_Portugal
Fulk,_King_of_Jerusalem	hasChild	Melisende,_Queen_of_Jerusalem
Christian_III_of_Denmark	isMarriedTo	Dorothea_of_Saxe-Lauenburg
Peter_the_Great	hasChild	Elizabeth_of_Russia
Amitabh_Bachchan	hasChild	Abhishek_Bachchan
Eleanor_of_Castile	isMarriedTo	Edward_I_of_England
Philip_V_of_Spain	hasChild	Charles_III_of_Spain
Sophia_of_Minsk	hasChild	Valdemar_II_of_Denmark
Catherine_Jagiellon	isMarriedTo	John_III_of_Sweden
Philip_II_of_France	isMarriedTo	Isabelle_of_Hainaut
Mary_of_Teck	hasChild	Prince_Henry,_Duke_of_Gloucester
Charles_V,_Holy_Roman_Emperor	hasChild	Philip_II_of_Spain
Wilhelmine_Amalia_of_Brunswick-Lüneburg	isMarriedTo	Joseph_I,_Holy_Roman_Emperor
Archduke_Charles,_Duke_of_Teschen	hasChild	Archduke_Karl_Ferdinand_of_Austria
Alexander_II_of_Russia	hasChild	Grand_Duke_Paul_Alexandrovich_of_Russia
Agnes_of_Poitou	isMarriedTo	Henry_III,_Holy_Roman_Emperor
Charles_III_of_Naples	hasChild	Ladislaus_of_Naples
Henry_I_of_France	isMarriedTo	Conrad_II,_Holy_Roman_Emperor
Louisa_Adams	hasChild	Charles_Francis_Adams,_Sr.
Olga_Feodorovna_of_Baden	hasChild	Grand_Duke_George_Mikhailovich_of_Russia_(1863–1919)
Anna_von_Schweidnitz	isMarriedTo	Charles_IV,_Holy_Roman_Emperor
Mary_Tudor,_Queen_of_France	hasChild	Claude_of_France
Gerald_Ford	hasChild	Jimmy_Carter
Blythe_Danner	isMarriedTo	Bruce_Paltrow
Constance_of_Hungary	hasChild	Kunigunde_of_Hohenstaufen
Calvin_Coolidge	isMarriedTo	Grace_Coolidge
Françoise_Marie_de_Bourbon	hasChild	Louise_Élisabeth_d'Orléans
Adelaide_of_Maurienne	hasChild	Eleanor_of_Aquitaine
Phoebe_Ephron	hasChild	Delia_Ephron
Leopold,_Duke_of_Lorraine	hasChild	Francis_I,_Holy_Roman_Emperor
Baldwin_I_of_Constantinople	hasChild	Henry_of_Flanders
Frederick_II,_Holy_Roman_Emperor	isMarriedTo	Constance_of_Aragon
Bruce_Dern	isMarriedTo	Diane_Ladd
Elizabeth_of_Bohemia	hasChild	Sophia_of_Hanover
Charles_III_of_Spain	isMarriedTo	Maria_Amalia_of_Saxony
Sibylla_of_Anjou	hasChild	Margaret_I,_Countess_of_Flanders
Eleanor_of_Aragon,_Queen_of_Portugal	isMarriedTo	Edward,_King_of_Portugal
Rose_Kennedy	hasChild	Ted_Kennedy
Margaret_of_Austria,_Queen_of_Spain	hasChild	Philip_IV_of_Spain
Peter_the_Great	isMarriedTo	Catherine_I_of_Russia
William_I,_German_Emperor	hasChild	Frederick_III,_German_Emperor
Sigrid_the_Haughty	hasChild	Emma_of_Normandy
Sophia_of_Nassau	hasChild	Victoria_of_Baden
Frederick_William_III_of_Prussia	hasChild	Wilhelm_I_of_Germany
Henry_II_of_England	hasChild	Richard_I_of_England
Lenore_Romney	hasChild	Mitt_Romney
Ferdinand_III_of_Castile	hasChild	Henry_of_Castile_the_Senator
Elizabeth_II	hasChild	Prince_Andrew,_Duke_of_York
Fausta	hasChild	Constantius_II
Francis_I,_Holy_Roman_Emperor	hasChild	Leopold_II,_Holy_Roman_Emperor
Lucille_Ball	hasChild	Desi_Arnaz,_Jr.
Hassa_bint_Ahmed_Al_Sudairi	hasChild	Nayef_bin_Abdul-Aziz_Al_Saud
Theodore_Roosevelt,_Sr.	isMarriedTo	Martha_Bulloch_Roosevelt
Elisabeth_Farnese	hasChild	Charles_III_of_Spain
Philippe,_Duke_of_Orléans,_Regent_of_France	hasChild	Louis_d'Orléans,_Duke_of_Orléans
Archduchess_Louise_of_Austria	hasChild	Friedrich_Christian,_Margrave_of_Meissen
Lilian,_Princess_of_Réthy	hasChild	Queen_Fabiola_of_Belgium
John_of_Bohemia	hasChild	Wenceslaus_I,_Duke_of_Luxembourg
Judith_of_Habsburg	hasChild	Elizabeth_Richeza_of_Poland
Hassa_bint_Ahmed_Al_Sudairi	hasChild	Salman_bin_Abdulaziz_Al_Saud
Mary_of_Teck	isMarriedTo	George_V
Mary_Tudor,_Queen_of_France	isMarriedTo	Charles_Brandon,_1st_Duke_of_Suffolk
Savang_Vadhana	isMarriedTo	Chulalongkorn
William_I_of_Württemberg	isMarriedTo	Catherine_Pavlovna_of_Russia
Alfonso_VIII_of_Castile	hasChild	Urraca_of_Castile,_Queen_of_Portugal
Charles_III_of_Naples	hasChild	Joanna_II_of_Naples
Gena_Rowlands	isMarriedTo	John_Cassavetes
Eleanor_of_Portugal,_Holy_Roman_Empress	hasChild	Bianca_Maria_Sforza
Charles_I_of_Naples	hasChild	Peter_III_of_Aragon
Alfonso_VIII_of_Castile	isMarriedTo	Eleanor_of_England,_Queen_of_Castile
John_IV_of_Portugal	hasChild	Peter_II_of_Portugal
Sigismund_III_Vasa	isMarriedTo	Constance_of_Austria
Princess_Mary_Adelaide_of_Cambridge	hasChild	Mary_of_Teck
Baldwin_I_of_Constantinople	hasChild	Margaret_II,_Countess_of_Flanders
Lady_Bird_Johnson	isMarriedTo	Lyndon_B._Johnson
Anna_von_Schweidnitz	hasChild	Elizabeth_of_Pomerania
Winston_Churchill	isMarriedTo	Clementine_Churchill,_Baroness_Spencer-Churchill
Theodore_Roosevelt,_Sr.	hasChild	Theodore_Roosevelt
James_V_of_Scotland	isMarriedTo	Mary_of_Guise
John_Cassavetes	hasChild	Nick_Cassavetes
Alexander_III_of_Russia	hasChild	Nicholas_II_of_Russia
Albert_I_of_Belgium	hasChild	Marie_José_of_Belgium
Prince_Bernhard_of_the_Netherlands	hasChild	Princess_Margriet_of_the_Netherlands
Agnes_of_Germany	hasChild	Gertrude_of_Babenberg,_Duchess_of_Bohemia
Ptolemy_VIII_Physcon	hasChild	Ptolemy_X_Alexander_I
John_II_of_Aragon	hasChild	Louis_XI_of_France
Charles_VIII_of_France	hasChild	Louis_XII_of_France
Barbara_of_Cilli	hasChild	Elizabeth_of_Luxembourg
Ferdinand_II_of_the_Two_Sicilies	hasChild	Francis_II_of_the_Two_Sicilies
Françoise_Marie_de_Bourbon	hasChild	Louis_d'Orléans,_Duke_of_Orléans
Louis_XIII_of_France	hasChild	Louis_XIV_of_France
Queen_Sofía_of_Spain	hasChild	Infanta_Cristina,_Duchess_of_Palma_de_Mallorca
Janet_Leigh	isMarriedTo	Tony_Curtis
Isabella_of_Clermont	hasChild	Beatrice_of_Naples
George_III_of_the_United_Kingdom	hasChild	William_IV_of_the_United_Kingdom
Constance_of_Arles	hasChild	Adela_of_France,_Countess_of_Flanders
Ibn_Saud	hasChild	Abdullah_of_Saudi_Arabia
John_Farrow	isMarriedTo	Maureen_O'Sullivan
William_the_Conqueror	hasChild	Henry_I_of_England
Louise_of_Mecklenburg-Strelitz	hasChild	Wilhelm_I_of_Germany
Bonne_of_Bohemia	hasChild	Joan_of_Valois,_Queen_of_Navarre
Princess_Alexandra_of_Saxe-Altenburg	isMarriedTo	Grand_Duke_Konstantin_Nikolayevich_of_Russia
Oscar_II_of_Sweden	hasChild	Prince_Oscar_Bernadotte
Ferdinand_Maria,_Elector_of_Bavaria	hasChild	Duchess_Violante_Beatrice_of_Bavaria
Philip_III_of_Spain	hasChild	Philip_IV_of_Spain
George_VI_of_the_United_Kingdom	isMarriedTo	Queen_Elizabeth_The_Queen_Mother
Maria_Luisa_of_Parma	isMarriedTo	Charles_IV_of_Spain
George_W._Bush	hasChild	Jenna_Bush_Hager
Oliver_Cromwell	isMarriedTo	Elizabeth_Cromwell
Siim_Kallas	hasChild	Toomas_Hendrik_Ilves
Maria_Josepha_of_Saxony,_Dauphine_of_France	isMarriedTo	Louis,_Dauphin_of_France_(1729–1765)
Vic_Morrow	isMarriedTo	Barbara_Turner_(actress)
Dorothea_of_Brandenburg	hasChild	Frederick_I_of_Denmark
Eleanor_Roosevelt	isMarriedTo	Franklin_D._Roosevelt
George_III_of_the_United_Kingdom	hasChild	Prince_Adolphus,_Duke_of_Cambridge
Charles_II_of_Navarre	hasChild	Charles_VI_of_France
Philip_V_of_Spain	hasChild	Ferdinand_VI_of_Spain
Isabeau_of_Bavaria	hasChild	Joan_of_France,_Duchess_of_Brittany
Arlene_Dahl	hasChild	Lorenzo_Lamas
Jacques_Chirac	hasChild	Robert_Boulin
Edward_VII	hasChild	George_V
Victor_Amadeus_I,_Duke_of_Savoy	hasChild	Princess_Henriette_Adelaide_of_Savoy
Dolores_Costello	isMarriedTo	John_Barrymore
Maria_Anna_of_Savoy	isMarriedTo	Ferdinand_I_of_Austria
Francis_I,_Holy_Roman_Emperor	isMarriedTo	Maria_Theresa
Philip,_Duke_of_Parma	hasChild	Ferdinand,_Duke_of_Parma
Catherine_de'_Medici	hasChild	Charles_IX_of_France
Alexandra_Feodorovna_(Charlotte_of_Prussia)	hasChild	Grand_Duke_Nicholas_Nikolaevich_of_Russia_(1831–1891)
Ferdinand_Marcos	isMarriedTo	Imelda_Marcos
Joan,_Countess_of_Flanders	isMarriedTo	Thomas,_Count_of_Flanders
Gisela_of_Swabia	hasChild	Henry_III,_Holy_Roman_Emperor
Archduchess_Elisabeth_Franziska_of_Austria	hasChild	Maria_Christina_of_Austria
Gustaf_V_of_Sweden	isMarriedTo	Victoria_of_Baden
Eleanor_of_Aquitaine	isMarriedTo	Louis_VII_of_France
Benazir_Bhutto	hasChild	Bilawal_Bhutto_Zardari
Catherine_of_Medici	hasChild	Charles_III,_Duke_of_Lorraine
Maria_Leopoldina_of_Austria	hasChild	Maria_II_of_Portugal
Charles_XI_of_Sweden	isMarriedTo	Ulrika_Eleonora_of_Denmark
Charles_VI,_Holy_Roman_Emperor	hasChild	Maria_Theresa_of_Austria
Grace_Coolidge	hasChild	Lou_Henry_Hoover
Archduke_Karl_Ferdinand_of_Austria	hasChild	Archduke_Friedrich,_Duke_of_Teschen
Chlothar_I	hasChild	Chilperic_I
Elizabeth_of_Luxembourg	isMarriedTo	Albert_II_of_Germany
Olav_V_of_Norway	hasChild	Princess_Astrid,_Mrs._Ferner
Matilda_of_Boulogne	hasChild	Eleanor_of_Aquitaine
Charlemagne	isMarriedTo	Hildegard_of_Vinzgouw
Miguel_I_of_Portugal	hasChild	Infanta_Marie_Anne_of_Portugal
Ramon_Berenguer_IV,_Count_of_Provence	hasChild	Beatrice_of_Provence
William,_Duke_of_Jülich-Cleves-Berg	hasChild	John_William,_Duke_of_Jülich-Cleves-Berg
Anna_von_Schweidnitz	hasChild	Wenceslaus_IV_of_Bohemia
Władysław_I_the_Elbow-high	hasChild	Elizabeth_of_Poland,_Queen_of_Hungary
Viviane_Reding	isMarriedTo	Dalia_Grybauskaitė
Princess_Augusta_Wilhelmine_of_Hesse-Darmstadt	isMarriedTo	Maximilian_I_Joseph_of_Bavaria
Louis,_Dauphin_of_France_(1729–1765)	isMarriedTo	Maria_Josepha_of_Saxony,_Dauphine_of_France
Elizabeth_of_Bohemia_(1292–1330)	hasChild	Blanche_of_Valois
Elizabeth_of_Bosnia	isMarriedTo	Louis_I_of_Hungary
Sigismund,_Holy_Roman_Emperor	hasChild	Frederick_III,_Holy_Roman_Emperor
Elena_of_Montenegro	isMarriedTo	Vittorio_Emanuele_III
Frederica_of_Mecklenburg-Strelitz	hasChild	George_V_of_Hanover
Princess_Maria_Josepha_of_Saxony_(1731–1767)	hasChild	Charles_X_of_France
Frederick_Augustus_III_of_Saxony	isMarriedTo	Archduchess_Louise_of_Austria
Augusta_Victoria_of_Schleswig-Holstein	isMarriedTo	Wilhelm_II_of_Germany
Sophie_Amalie_of_Brunswick-Lüneburg	isMarriedTo	Frederick_III_of_Denmark
Pedro_II_of_Brazil	isMarriedTo	Teresa_Cristina_of_the_Two_Sicilies
Casimir_IV_Jagiellon	hasChild	Vladislaus_II_of_Hungary
Frederick_VIII_of_Denmark	isMarriedTo	Louise_of_Sweden
Queen_Victoria	hasChild	Edward_VII
Amalric_I_of_Jerusalem	hasChild	Isabella_I_of_Jerusalem
Maria_Alexandrovna_(Marie_of_Hesse)	hasChild	Maria_Feodorovna_(Dagmar_of_Denmark)
Margaret,_Countess_of_Anjou	isMarriedTo	Charles_III_of_Naples
Frederick_II_Eugene,_Duke_of_Württemberg	hasChild	Duke_Louis_of_Württemberg
Ludwig_I_of_Bavaria	hasChild	Otto,_King_of_Greece
Pythodorida_of_Pontus	hasChild	Antonia_Tryphaena
Charles_IV,_Holy_Roman_Emperor	hasChild	Catherine_of_Bohemia
Jobst_of_Moravia	isMarriedTo	Barbara_of_Cilli
Philip_II_of_Spain	hasChild	Albert_VII,_Archduke_of_Austria
Paul_I_of_Russia	hasChild	Grand_Duke_Constantine_Pavlovich_of_Russia
Wilhelmine_Amalia_of_Brunswick-Lüneburg	hasChild	Elisabeth_Christine_of_Brunswick-Wolfenbüttel
Maria_Theresa_of_Austria-Este,_Queen_of_Sardinia	hasChild	Maria_Anna_of_Savoy
Charles_IV_of_Spain	hasChild	Infante_Carlos,_Count_of_Molina
Louis_I_of_Hungary	hasChild	Charles_III_of_Naples
Archduchess_Elisabeth_Franziska_of_Austria	hasChild	Archduke_Charles_Stephen_of_Austria
Queen_Silvia_of_Sweden	hasChild	Prince_Carl_Philip_of_Sweden
María_Isabella_of_Spain	hasChild	Princess_Maria_Antonia_of_the_Two_Sicilies
Jobst_of_Moravia	hasChild	Elisabeth,_Duchess_of_Luxembourg
Louis_VII_of_France	isMarriedTo	Adèle_of_Champagne
Joseph_I,_Holy_Roman_Emperor	hasChild	Charles_VI,_Holy_Roman_Emperor
Abby_Aldrich_Rockefeller	hasChild	Winthrop_Rockefeller
Edward_I_of_England	hasChild	Joan_of_Acre
Franz_Joseph_I_of_Austria	hasChild	Archduchess_Gisela_of_Austria
Christian_I_of_Denmark	isMarriedTo	Dorothea_of_Brandenburg
Catherine_of_Valois	hasChild	Henry_VI_of_England
Princess_Marie_of_Orléans_(1865–1909)	hasChild	Princess_Margaret_of_Denmark
Sean_Connery	hasChild	Jason_Connery
Bill_Clinton	hasChild	George_W._Bush
Nicholas_I_of_Russia	isMarriedTo	Alexandra_Feodorovna_(Charlotte_of_Prussia)
Anne_of_Austria	hasChild	Louis_XIV_of_France
Shirley_Jones	hasChild	Shaun_Cassidy
Louis_XV_of_France	hasChild	Louis_XVI_of_France
fr/Carlos_Fabião	isMarriedTo	fr/Silvano_Ribeiro
Anne_Eleonore_of_Hesse-Darmstadt	isMarriedTo	George,_Duke_of_Brunswick-Lüneburg
Maria_Theresa_of_Austria,_Queen_of_the_Two_Sicilies	hasChild	Princess_Maria_Annunciata_of_Bourbon-Two_Sicilies
Ferdinand_VII_of_Spain	isMarriedTo	Maria_Christina_of_the_Two_Sicilies
Constance_of_Arles	hasChild	Adèle_of_France,_Countess_of_Flanders
Baldwin_I_of_Constantinople	isMarriedTo	Marie_of_Champagne
Therese_of_Saxe-Hildburghausen	isMarriedTo	Ludwig_I_of_Bavaria
Eddie_Fisher_(singer)	isMarriedTo	Debbie_Reynolds
Bolesław_III_Wrymouth	hasChild	Casimir_II_the_Just
George_W._Bush	hasChild	Barack_Obama
Charlotte_of_Savoy	isMarriedTo	Louis_XI_of_France
Bianca_Maria_Sforza	hasChild	Isabella_of_Portugal
Béla_III_of_Hungary	hasChild	Constance_of_Hungary
Ernest_Augustus,_Elector_of_Brunswick-Lüneburg	hasChild	Sophia_Charlotte_of_Hanover
Sophia_Charlotte_of_Hanover	isMarriedTo	Frederick_I_of_Prussia
Louis,_Duke_of_Savoy	isMarriedTo	Anne_of_Cyprus
Pedro_I_of_Brazil	hasChild	Maria_Leopoldina_of_Austria
Sean_Connery	isMarriedTo	Diane_Cilento
Eddie_Fisher_(singer)	hasChild	Carrie_Fisher
John_F._Kennedy	isMarriedTo	Jacqueline_Kennedy_Onassis
Sancho_I_of_Portugal	hasChild	Berengaria_of_Portugal
Christian_X_of_Denmark	hasChild	Frederick_IX_of_Denmark
Victoria,_Princess_Royal	hasChild	Wilhelm_II_of_Germany
Infante_Juan,_Count_of_Barcelona	isMarriedTo	Princess_María_de_las_Mercedes_of_Bourbon-Two_Sicilies
Ottokar_II_of_Bohemia	isMarriedTo	Kunigunda_of_Halych
Philippa_of_Hainault	hasChild	Lionel_of_Antwerp,_1st_Duke_of_Clarence
Henry_II,_Duke_of_Austria	hasChild	Henry_the_Lion
Alexandrine_of_Mecklenburg-Schwerin	isMarriedTo	Christian_X_of_Denmark
Maria_Josepha_of_Saxony,_Dauphine_of_France	hasChild	Louis_XVI_of_France
Władysław_I_Herman	hasChild	Bolesław_III_Wrymouth
Frederick_III,_German_Emperor	hasChild	Princess_Margaret_of_Prussia
Philip_the_Good	isMarriedTo	Bonne_of_Artois
Grand_Duchess_Anna_Pavlovna_of_Russia	hasChild	William_III_of_the_Netherlands
Pieter_van_Vollenhoven	hasChild	Prince_Bernhard_of_Orange-Nassau,_van_Vollenhoven
Rose_Kennedy	hasChild	John_F._Kennedy
José_Pedro_Pérez-Llorca	isMarriedTo	Leopoldo_Calvo-Sotelo
Princess_Margaret_of_Connaught	hasChild	Ingrid_of_Sweden
Ferdinand_II_of_Aragon	hasChild	Maria_of_Aragon,_Queen_of_Portugal
Keohokālole	hasChild	Kalākaua
Maria_Theresa_of_Austria	hasChild	Joseph_II,_Holy_Roman_Emperor
Joan_II_of_Navarre	isMarriedTo	Philip_III_of_Navarre
Catherine_of_Aragon	hasChild	Mary_I_of_England
James_V_of_Scotland	hasChild	Mary,_Queen_of_Scots
Adolf_Frederick_of_Sweden	hasChild	Gustav_III_of_Sweden
George_VI_of_the_United_Kingdom	hasChild	Princess_Margaret,_Countess_of_Snowdon
Elisabeth_Christine_of_Brunswick-Wolfenbüttel	isMarriedTo	Charles_VI,_Holy_Roman_Emperor
Maria_Anna_of_Bavaria_(1551–1608)	hasChild	Constance_of_Austria
Kamehameha_II	hasChild	Kamehameha_III
Duke_Maximilian_Joseph_in_Bavaria	isMarriedTo	Princess_Ludovika_of_Bavaria
Margaret_of_Valois	isMarriedTo	Henry_IV_of_France
Maria_Francisca_of_Savoy	hasChild	Maria_Sophia_of_Neuburg
Berenice_I_of_Egypt	isMarriedTo	Ptolemy_I_Soter
Wenceslaus_II_of_Bohemia	hasChild	Bolesław_III_the_Generous
Infanta_Catherine_Michelle_of_Spain	isMarriedTo	Charles_Emmanuel_I,_Duke_of_Savoy
Sophia_of_Hanover	hasChild	Sophia_Charlotte_of_Hanover
François_Mitterrand	hasChild	Maurice_Faure
Constance_of_Arles	isMarriedTo	Robert_II_of_France
Bertha_of_Savoy	hasChild	Agnes_of_Germany
Olli_Rehn	hasChild	Viviane_Reding
Prince_Carl,_Duke_of_Västergötland	hasChild	Astrid_of_Sweden
James_II,_Count_of_La_Marche	isMarriedTo	Joanna_II_of_Naples
Mariana_of_Austria	isMarriedTo	Philip_IV_of_Spain
Baldwin_V,_Count_of_Hainaut	hasChild	Henry_of_Flanders
Benigno_Aquino,_Jr.	isMarriedTo	Corazon_Aquino
John_II_of_France	hasChild	Joan_of_Valois,_Queen_of_Navarre
Matilda_of_Scotland	isMarriedTo	Henry_I_of_England
Gordon_Brown	hasChild	David_Cameron
Agnes_of_Poitou	hasChild	Judith_of_Swabia
Gustaf_VI_Adolf_of_Sweden	isMarriedTo	Princess_Margaret_of_Connaught
Louis_I_of_Spain	isMarriedTo	Louise_Élisabeth_d'Orléans
fr/Carlos_Fabião	hasChild	Adelino_da_Palma_Carlos
Joseph_P._Kennedy,_Sr.	isMarriedTo	Rose_Kennedy
Afonso_II_of_Portugal	isMarriedTo	Urraca_of_Castile,_Queen_of_Portugal
Ibn_Saud	hasChild	Fahd_of_Saudi_Arabia
Ferdinand_III,_Holy_Roman_Emperor	hasChild	Leopold_I,_Holy_Roman_Emperor
Isabeau_of_Bavaria	isMarriedTo	Charles_VI_of_France
Anne_Catherine_of_Brandenburg	isMarriedTo	Christian_IV_of_Denmark
Princess_Maria_Antonia_of_the_Two_Sicilies	hasChild	Ferdinand_IV,_Grand_Duke_of_Tuscany
Peter_III_of_Aragon	hasChild	James_II_of_Aragon
Maria_Theresa_of_Austria_(1816–1867)	isMarriedTo	Ferdinand_II_of_the_Two_Sicilies
Maria_Christina_of_Austria	hasChild	Victoria_Eugenie_of_Battenberg
Martin_I_of_Sicily	isMarriedTo	Blanche_I_of_Navarre
Ethelred_the_Unready	hasChild	Sweyn_I_of_Denmark
Elisabetta_Farnese	hasChild	Mariana_Victoria_of_Spain
George_H._W._Bush	hasChild	George_W._Bush
Charles_VI_of_France	hasChild	Catherine_of_Valois
Christopher_of_Bavaria	hasChild	Charles_VIII_of_Sweden
Bill_Williams_(actor)	isMarriedTo	Barbara_Hale
Marie_Thérèse_of_Austria	hasChild	Louis,_Grand_Dauphin
Philip_IV_of_France	hasChild	Isabella_of_France
Prince_Valdemar_of_Denmark	isMarriedTo	Princess_Marie_of_Orléans_(1865–1909)
Eleanor_of_Aragon,_Queen_of_Portugal	hasChild	Afonso_V_of_Portugal
Helen_(actress)	isMarriedTo	Salim_Khan
Victor_Amadeus_II_of_Sardinia	isMarriedTo	Anne_Marie_d'Orléans
Maria_Josepha_of_Austria	isMarriedTo	Augustus_III_of_Poland
Kalākua_Kaheiheimālie	hasChild	Kamehameha_V
Louise_of_Sweden	hasChild	Prince_Harald_of_Denmark
Frederick_William_III_of_Prussia	hasChild	Frederick_William_IV_of_Prussia
Margrethe_II_of_Denmark	hasChild	Prince_Joachim_of_Denmark
Philip_III_of_Spain	hasChild	Anne_of_Austria
George,_King_of_Saxony	hasChild	Frederick_Augustus_III_of_Saxony
Joanna_of_Castile	hasChild	Ferdinand_I,_Holy_Roman_Emperor
Bolesław_III_Wrymouth	hasChild	Mieszko_III_the_Old
Leopold_III_of_Belgium	isMarriedTo	Astrid_of_Sweden
Princess_Ludovika_of_Bavaria	isMarriedTo	Duke_Maximilian_Joseph_in_Bavaria
Agrippina_the_Elder	hasChild	Agrippina_the_Younger
Alexander_II_of_Russia	hasChild	Alexander_III_of_Russia
Louis_I_of_Spain	hasChild	Philip_V_of_Spain
Frederick_I,_Margrave_of_Brandenburg-Ansbach	hasChild	George,_Margrave_of_Brandenburg-Ansbach
Archduchess_Maria_Amalia_of_Austria	isMarriedTo	Ferdinand,_Duke_of_Parma
Henry_VII,_Holy_Roman_Emperor	hasChild	Frederick_the_Fair
Lothar_Bisky	hasChild	Klaus_Ernst
Ernest_I,_Duke_of_Saxe-Gotha	hasChild	Frederick_I,_Duke_of_Saxe-Gotha-Altenburg
Oliver_Cromwell	hasChild	Richard_Cromwell
Princess_Isabelle_of_Orléans_(1878–1961)	isMarriedTo	Prince_Jean,_Duke_of_Guise
Charles_II_of_Spain	hasChild	Louis_XIV_of_France
Sophia_Jagiellon,_Margravine_of_Brandenburg-Ansbach	hasChild	Albert,_Duke_in_Prussia
Maria_Alexandrovna_(Marie_of_Hesse)	hasChild	Grand_Duke_Paul_Alexandrovich_of_Russia
Julia_the_Elder	isMarriedTo	Tiberius
Philip_the_Bold	hasChild	John_the_Fearless
Margrethe_II_of_Denmark	isMarriedTo	Henrik,_Prince_Consort_of_Denmark
Agnes_of_Merania	hasChild	Blanche_of_Castile
Sophie_of_Mecklenburg-Güstrow	hasChild	Anne_Catherine_of_Brandenburg
George,_Duke_of_Brunswick-Lüneburg	hasChild	John_Frederick,_Duke_of_Brunswick-Lüneburg
Françoise_d'Aubigné,_Marquise_de_Maintenon	hasChild	Marie_Leszczyńska
Maria_Feodorovna_(Dagmar_of_Denmark)	hasChild	Alexandra_Fyodorovna
Philip_IV_of_France	hasChild	Charles_IV_of_France
Christine_Marie_of_France	hasChild	Charles_Emmanuel_II,_Duke_of_Savoy
Gertrude_of_Hohenburg	hasChild	Judith_of_Habsburg
Agnes_of_Germany	hasChild	Agnes_of_Babenberg
Yaroslav_the_Wise	hasChild	Sviatoslav_II_of_Kiev
John_I_of_Portugal	hasChild	Isabella_of_Portugal,_Duchess_of_Burgundy
Margaret_of_Brabant	hasChild	John_of_Bohemia
Elisabeth_of_Valois	hasChild	Anna_of_Austria,_Queen_of_Spain
Joanna_II_of_Naples	hasChild	René_of_Anjou
Letizia_Ramolino	hasChild	Joseph_Bonaparte
Prince_Felix_of_Bourbon-Parma	hasChild	Princess_Joséphine_Charlotte_of_Belgium
John,_King_of_Denmark	isMarriedTo	Christina_of_Saxony
Harald_V_of_Norway	isMarriedTo	Queen_Sonja_of_Norway
Maria_Beatrice_d'Este,_Duchess_of_Massa	isMarriedTo	Ferdinand,_Duke_of_Breisgau
Rezā_Shāh	hasChild	Mohammad_Reza_Pahlavi
François_Hollande	isMarriedTo	Ségolène_Royal
Maria_Luisa_of_Spain	hasChild	Ferdinand_III,_Grand_Duke_of_Tuscany
Grace_Coolidge	isMarriedTo	Calvin_Coolidge
Frederick_William_II_of_Prussia	hasChild	Wilhelmine_of_Prussia,_Queen_of_the_Netherlands
Nicholas_I_of_Russia	hasChild	Alexander_II_of_Russia
Princess_Margaret_of_Connaught	hasChild	Prince_Gustaf_Adolf,_Duke_of_Västerbotten
Catherine_de'_Medici	hasChild	Elisabeth_of_Valois
Conrad_of_Montferrat	hasChild	Henry_II,_Count_of_Champagne
Joanna_of_Castile	isMarriedTo	Philip_I_of_Castile
Wilhelm_I_of_Germany	hasChild	Friedrich_III_of_Germany
Baldwin_V,_Count_of_Flanders	hasChild	Matilda_of_Flanders
Ferdinand_I_of_Bulgaria	isMarriedTo	Princess_Marie_Louise_of_Bourbon-Parma
Elizabeth_of_York	isMarriedTo	Henry_VII_of_England
Astrid_of_Sweden	hasChild	Princess_Joséphine_Charlotte_of_Belgium
Landgravine_Elisabeth_Amalie_of_Hesse-Darmstadt	isMarriedTo	Philip_William,_Elector_Palatine
George_VI	isMarriedTo	Queen_Elizabeth_The_Queen_Mother
Ptolemy_VIII_Physcon	hasChild	Cleopatra_Selene_I
Joan_I,_Countess_of_Auvergne	hasChild	Joanna_of_Bourbon
Blanche_of_Anjou	isMarriedTo	James_II_of_Aragon
Joan_the_Lame	isMarriedTo	Philip_VI_of_France
Sigismund_I_the_Old	isMarriedTo	Bona_Sforza
Nicholas_I_of_Russia	hasChild	Grand_Duchess_Maria_Nikolaevna_of_Russia_(1819–1876)
Mary_I_of_England	hasChild	Elizabeth_I_of_England
Kunigunda_of_Halych	isMarriedTo	Ottokar_II_of_Bohemia
Sophie_Amalie_of_Brunswick-Lüneburg	hasChild	Charlotte_Amalie_of_Hesse-Kassel
Kapaakea	isMarriedTo	Keohokālole
Princess_Margriet_of_the_Netherlands	isMarriedTo	Pieter_van_Vollenhoven
Charles_I_of_England	hasChild	James_II_of_England
Victor_Emmanuel_III_of_Italy	hasChild	Umberto_II_of_Italy
Elena_of_Montenegro	hasChild	Giovanna_of_Italy
Margaret_of_Durazzo	isMarriedTo	Charles_III_of_Naples
Augusta_of_Saxe-Weimar-Eisenach	hasChild	Friedrich_III_of_Germany
Conrad_of_Montferrat	hasChild	Isabella_I_of_Jerusalem
Elisabeth_of_Habsburg_(1436–1505)	hasChild	Sophia_Jagiellon,_Margravine_of_Brandenburg-Ansbach
Alexandra_of_Denmark	isMarriedTo	Edward_VII
Princess_Henriette_Adelaide_of_Savoy	isMarriedTo	Ferdinand_Maria,_Elector_of_Bavaria
John_IV,_Duke_of_Brittany	isMarriedTo	Joan,_Countess_of_Flanders
Dalia_Grybauskaitė	isMarriedTo	Viviane_Reding
Richard_I_of_England	hasChild	Otto_IV,_Holy_Roman_Emperor
Grand_Duke_Michael_Nikolaevich_of_Russia	hasChild	Grand_Duke_Alexei_Mikhailovich_of_Russia
Roberto_Rossellini	hasChild	Isabella_Rossellini
Frederick_V,_Elector_Palatine	isMarriedTo	Elizabeth_of_Bohemia
Anthony,_Duke_of_Brabant	isMarriedTo	Elisabeth,_Duchess_of_Luxembourg
Charles_Frederick,_Grand_Duke_of_Saxe-Weimar-Eisenach	hasChild	Augusta_of_Saxe-Weimar-Eisenach
Cornelius_Vanderbilt_II	isMarriedTo	Alice_Claypoole_Gwynne
Matilda_II,_Countess_of_Boulogne	hasChild	Beatrice_of_Castile_(1242–1303)
Alexander_III_of_Russia	hasChild	Grand_Duchess_Xenia_Alexandrovna_of_Russia
Pankaj_Kapur	isMarriedTo	Supriya_Pathak
Wilhelm_II,_German_Emperor	hasChild	Prince_Oskar_of_Prussia
Louis_XIV_of_France	hasChild	Louis_XV_of_France
Henry_III,_Holy_Roman_Emperor	isMarriedTo	Gunhilda_of_Denmark
Alexandra_Feodorovna_(Charlotte_of_Prussia)	hasChild	Grand_Duke_Michael_Nikolaevich_of_Russia
Louise_of_Hesse-Kassel	hasChild	Frederick_VIII_of_Denmark
Robert_II_of_France	hasChild	Henry_I_of_France
Louis_XVI_of_France	isMarriedTo	Marie_Antoinette
Gisela_of_Swabia	isMarriedTo	Conrad_II,_Holy_Roman_Emperor
Demetrius_II_Nicator	isMarriedTo	Cleopatra_Thea
Francis_II,_Holy_Roman_Emperor	hasChild	Maria_Leopoldina_of_Austria
Letizia_Ramolino	hasChild	Napoleon
Maria_Christina_of_the_Two_Sicilies	hasChild	Isabella_II_of_Spain
Duke_Henry_of_Mecklenburg-Schwerin	isMarriedTo	Wilhelmina_of_the_Netherlands
Henry_VI,_Holy_Roman_Emperor	hasChild	Frederick_II,_Holy_Roman_Emperor
Princess_Augusta_of_Bavaria	hasChild	Josephine_of_Leuchtenberg
Anne_of_Austria	hasChild	Philippe,_Duke_of_Orléans
Claude_of_Valois	hasChild	Henry_II,_Duke_of_Lorraine
Archduke_Ferdinand_Karl_Viktor_of_Austria-Este	hasChild	Maria_Theresa_of_Austria-Este_(1849–1919)
Beatrice_of_Savoy	hasChild	Margaret_of_Provence
Louise_of_Hesse-Kassel	hasChild	Prince_Valdemar_of_Denmark
Louis,_Duke_of_Savoy	hasChild	Margaret_of_Savoy,_Countess_of_Saint-Pol
Henry_IV_of_England	isMarriedTo	Joan_of_Navarre,_Queen_of_England
Maureen_O'Sullivan	hasChild	Mia_Farrow
Henry_III_of_England	isMarriedTo	Eleanor_of_Provence
Eleanor_of_Castile	hasChild	Joan_of_Acre
Olof_Skötkonung	hasChild	Iziaslav_I_of_Kiev
Cherie_Blair	hasChild	Sarah_Jane_Brown
Philip_I,_Duke_of_Brabant	isMarriedTo	Jacqueline,_Countess_of_Hainaut
Ercole_I_d'Este,_Duke_of_Ferrara	hasChild	Alfonso_I_d'Este,_Duke_of_Ferrara
Eleanor_of_Provence	isMarriedTo	Henry_III_of_England
Sigrid_the_Haughty	hasChild	Olof_Skötkonung
Margaret_of_Durazzo	hasChild	Joanna_II_of_Naples
John_D._Rockefeller,_Jr.	hasChild	Nelson_Rockefeller
Asif_Ali_Zardari	isMarriedTo	Benazir_Bhutto
Blanche_of_Castile	hasChild	Charles_I_of_Naples
Thabo_Mbeki	isMarriedTo	F._W._de_Klerk
Maria_Christina_of_the_Two_Sicilies	isMarriedTo	Ferdinand_VII_of_Spain
Elisabeth_of_Bavaria	hasChild	Archduchess_Gisela_of_Austria
Peter_III_of_Russia	hasChild	Catherine_the_Great
Saovabha_Phongsri	hasChild	Vajiravudh
Louis_II_of_Naples	hasChild	Marie_of_Anjou
Duke_Maximilian_Joseph_in_Bavaria	hasChild	Karl_Theodor,_Duke_in_Bavaria
Agnes_of_Antioch	hasChild	Andrew_II_of_Hungary
Carlos_I_of_Portugal	hasChild	Manuel_II_of_Portugal
Frederick_VIII_of_Denmark	hasChild	Princess_Ingeborg_of_Denmark
Maria_Feodorovna_(Sophie_Dorothea_of_Württemberg)	isMarriedTo	Paul_I_of_Russia
Alexander_II_of_Russia	hasChild	Grand_Duke_Vladimir_Alexandrovich_of_Russia
William,_Duke_of_Jülich-Cleves-Berg	hasChild	Charles_V,_Holy_Roman_Emperor
Casimir_III_of_Poland	isMarriedTo	Hedwig_of_Sagan
Ségolène_Royal	hasChild	Michel_Barnier
Ferdinand_II_of_the_Two_Sicilies	isMarriedTo	Maria_Cristina_of_Savoy
Henry_V_of_England	hasChild	John_of_Lancaster,_1st_Duke_of_Bedford
Maria_Pia_of_Savoy	hasChild	Amélie_of_Orléans
Carlo_Buonaparte	isMarriedTo	Letizia_Ramolino
Childebert_I	hasChild	Chlothar_I
Chlothar_I	isMarriedTo	Childebert_I
Adelaide_of_Austria	hasChild	Princess_Maria_Clotilde_of_Savoy
Elisabeth_of_Swabia	hasChild	Alfonso_X_of_Castile
Empress_Matilda	hasChild	Eleanor_of_Aquitaine
Helen_(actress)	hasChild	Salim_Khan
Ingegerd_Olofsdotter_of_Sweden	hasChild	Vsevolod_I_of_Kiev
Anne_Marie_Louise_d'Orléans,_Duchess_of_Montpensier	isMarriedTo	Charles_II_of_Spain
Erkki_Liikanen	hasChild	Olli_Rehn
Tony_Richardson	hasChild	Natasha_Richardson
John_D._Rockefeller,_Jr.	hasChild	John_D._Rockefeller_III
Victoria,_Princess_Royal	hasChild	Augusta_Victoria_of_Schleswig-Holstein
Henry_V_of_England	hasChild	Henry_VI_of_England
Victoria,_Princess_Royal	hasChild	Sophia_of_Prussia
Henry_II_of_France	isMarriedTo	Catherine_de'_Medici
Philip_II_of_Spain	isMarriedTo	Mary_I_of_England
Henry_Ephron	hasChild	Nora_Ephron
Frederick_III,_German_Emperor	hasChild	Wilhelm_II,_German_Emperor
Elisabeth_of_Bavaria,_Queen_of_Germany	hasChild	Elizabeth_of_Carinthia,_Queen_of_Germany
Virginia_Fox	isMarriedTo	Darryl_F._Zanuck
Neetu_Singh	hasChild	Ranbir_Kapoor
Bruce_Paltrow	hasChild	Gwyneth_Paltrow
Ernest_Augustus,_Elector_of_Brunswick-Lüneburg	hasChild	George_I_of_Great_Britain
Philip_I,_Count_of_Boulogne	hasChild	Matilda_II,_Countess_of_Boulogne
Isabella_of_Portugal	isMarriedTo	Charles_V,_Holy_Roman_Emperor
William_IV,_Grand_Duke_of_Luxembourg	isMarriedTo	Infanta_Marie_Anne_of_Portugal
Duchess_Helene_of_Mecklenburg-Schwerin	hasChild	Princess_Marie_Isabelle_of_Orléans
Elizabeth_Richeza_of_Poland	hasChild	Hedwig_of_Kalisz
Philip_the_Bold	isMarriedTo	Margaret_III,_Countess_of_Flanders
Violant_of_Hungary	hasChild	Constance_of_Sicily,_Queen_of_Aragon
Octavia_the_Younger	hasChild	Antonia_Minor
Elisabeth_of_Bavaria	hasChild	Zita_of_Bourbon-Parma
Adelaide_of_Löwenstein-Wertheim-Rosenberg	hasChild	Miguel,_Duke_of_Braganza
Astrid_of_Sweden	hasChild	Queen_Fabiola_of_Belgium
Empress_Kōjun	isMarriedTo	Hirohito
Kīnaʻu	hasChild	Kamehameha_V
Francis_I_of_Austria	hasChild	Archduke_Franz_Karl_of_Austria
Augusta_Victoria_of_Schleswig-Holstein	hasChild	Princess_Victoria_Louise_of_Prussia
George,_King_of_Saxony	isMarriedTo	Infanta_Maria_Anna_of_Portugal_(1843–1884)
Francis,_Duke_of_Teck	isMarriedTo	Princess_Mary_Adelaide_of_Cambridge
Gertrude_Vanderbilt_Whitney	hasChild	Cornelius_Vanderbilt_Whitney
John_I_of_Portugal	hasChild	Edward,_King_of_Portugal
Adèle_of_France,_Countess_of_Flanders	hasChild	Matilda_of_Flanders
Archduke_Karl_Ferdinand_of_Austria	isMarriedTo	Archduchess_Elisabeth_Franziska_of_Austria
Sigrid_the_Haughty	hasChild	Canute
George_V	isMarriedTo	Mary_of_Teck
Antipope_Felix_V	hasChild	Margaret_of_Savoy,_Duchess_of_Anjou
Henry_Ephron	hasChild	Delia_Ephron
William_II_of_the_Netherlands	hasChild	William_III_of_the_Netherlands
Milena_Vukotić	hasChild	Elena_of_Montenegro
Cleopatra_Thea	isMarriedTo	Demetrius_II_Nicator
Roger_II_of_Sicily	hasChild	William_I_of_Sicily
Pedro_I_of_Brazil	hasChild	Pedro_II_of_Brazil
Vittorio_Emanuele_III	hasChild	Giovanna_of_Italy
Thomas,_Count_of_Flanders	isMarriedTo	Joan,_Countess_of_Flanders
Jean,_Grand_Duke_of_Luxembourg	hasChild	Henri,_Grand_Duke_of_Luxembourg
Infanta_Maria_Anna_of_Portugal_(1843–1884)	hasChild	Frederick_Augustus_III_of_Saxony
Zein_al-Sharaf_Talal	hasChild	Hussein_of_Jordan
Philip_IV_of_Spain	hasChild	Marie_Thérèse_of_Austria
William_I,_German_Emperor	isMarriedTo	Augusta_of_Saxe-Weimar-Eisenach
Manfred,_King_of_Sicily	isMarriedTo	Beatrice_of_Savoy
Frederick_I,_Holy_Roman_Emperor	hasChild	Philip_of_Swabia
Amalric_II_of_Jerusalem	hasChild	Isabella_I_of_Jerusalem
Landgravine_Elisabeth_Amalie_of_Hesse-Darmstadt	hasChild	Eleonor_Magdalene_of_Neuburg
Philip,_Duke_of_Parma	hasChild	Maria_Luisa_of_Parma
Christian_IX_of_Denmark	isMarriedTo	Louise_of_Hesse-Kassel
Lolo_Soetoro	hasChild	Maya_Soetoro-Ng
Elisabeth_of_Habsburg_(1436–1505)	hasChild	Vladislaus_II_of_Hungary
Sophia_Dorothea_of_Hanover	hasChild	Frederick_the_Great
Prince_Alfonso,_Count_of_Caserta	hasChild	Prince_Carlos_of_Bourbon-Two_Sicilies
Ulrika_Eleonora,_Queen_of_Sweden	hasChild	Louisa_Ulrika_of_Prussia
Thomas_I,_Count_of_Savoy	hasChild	Beatrice_of_Savoy
Winston_Churchill	hasChild	Mary_Soames,_Baroness_Soames
Adèle_of_Champagne	isMarriedTo	Louis_VII_of_France
Maria_Antonia_Ferdinanda_of_Spain	hasChild	Victor_Emmanuel_I_of_Sardinia
Charlotte_of_Savoy	hasChild	Joan_of_France,_Duchess_of_Berry
Margravine_Friederike_of_Brandenburg-Schwedt	hasChild	Maria_Feodorovna_(Sophie_Dorothea_of_Württemberg)
Elizabeth_of_Luxembourg	hasChild	Isabella_of_Portugal,_Duchess_of_Burgundy
Emperor_Taizong_of_Tang	hasChild	Emperor_Gaozong_of_Tang
Agnes_of_Babenberg	isMarriedTo	Władysław_II_the_Exile
William_V,_Duke_of_Aquitaine	isMarriedTo	Agnes_of_Burgundy,_Duchess_of_Aquitaine
Elizabeth_of_Pomerania	hasChild	Barbara_of_Cilli
Archduke_Karl_Ludwig_of_Austria	hasChild	Archduke_Franz_Ferdinand_of_Austria
Eleanor_of_Alburquerque	isMarriedTo	Ferdinand_I_of_Aragon
Marcus_Vipsanius_Agrippa	hasChild	Agrippina_the_Elder
Mary_Wollstonecraft	isMarriedTo	William_Godwin
Letizia_Ramolino	hasChild	Louis_Bonaparte
Catherine_I_of_Russia	isMarriedTo	Peter_the_Great
Germanicus	isMarriedTo	Agrippina_the_Elder
Harry_Payne_Whitney	hasChild	Cornelius_Vanderbilt_Whitney
Elisabeth_of_Bavaria,_Queen_of_Belgium	hasChild	Leopold_III_of_Belgium
Zein_al-Sharaf_Talal	hasChild	Prince_Muhammad_bin_Talal
Władysław_I_Herman	isMarriedTo	Judith_of_Swabia
Charles_V,_Holy_Roman_Emperor	hasChild	Ferdinand_I,_Holy_Roman_Emperor
Salomea_of_Berg	isMarriedTo	Bolesław_III_Wrymouth
Frederick_I,_Grand_Duke_of_Baden	isMarriedTo	Princess_Louise_of_Prussia
George_H._W._Bush	hasChild	Bill_Clinton
Joan_of_France,_Duchess_of_Brittany	isMarriedTo	John_VI,_Duke_of_Brittany
Francis_I_of_France	isMarriedTo	Eleanor_of_Austria
William_the_Conqueror	isMarriedTo	Matilda_of_Flanders
Henry_X,_Duke_of_Bavaria	hasChild	Henry_the_Lion
Juliana_of_the_Netherlands	hasChild	Princess_Irene_of_the_Netherlands
Hillary_Rodham_Clinton	isMarriedTo	Bill_Clinton
Philip_V_of_Spain	isMarriedTo	Maria_Luisa_of_Savoy
Elizabeth_Stuart,_Queen_of_Bohemia	isMarriedTo	Frederick_V,_Elector_Palatine
Elena_of_Montenegro	hasChild	Umberto_II_of_Italy
Victor_Emmanuel_II_of_Italy	isMarriedTo	Adelaide_of_Austria
Linda_Christian	hasChild	Romina_Power
Bonne_of_Bohemia	hasChild	Philip_the_Bold
Elisabeth_of_Habsburg_(1436–1505)	isMarriedTo	Casimir_IV_Jagiellon
Cosimo_I_de'_Medici,_Grand_Duke_of_Tuscany	hasChild	Ferdinando_I_de'_Medici,_Grand_Duke_of_Tuscany
Maximilian_I_Joseph_of_Bavaria	hasChild	Princess_Augusta_of_Bavaria
Mary,_Queen_of_Hungary	isMarriedTo	Sigismund,_Holy_Roman_Emperor
Imelda_Marcos	isMarriedTo	Ferdinand_Marcos
Olga_Constantinovna_of_Russia	hasChild	Sophia_of_Prussia
Louis,_Grand_Dauphin	isMarriedTo	Duchess_Maria_Anna_Victoria_of_Bavaria
Charles_III_of_Naples	isMarriedTo	Margaret_of_Durazzo
Catherine_the_Great	hasChild	Maria_Feodorovna_(Sophie_Dorothea_of_Württemberg)
Adèle_of_France,_Countess_of_Flanders	isMarriedTo	Baldwin_V,_Count_of_Flanders
Elizabeth_Cromwell	isMarriedTo	Oliver_Cromwell
Agrippina_the_Younger	isMarriedTo	Claudius
Saint_Margaret_of_Scotland	isMarriedTo	Malcolm_III_of_Scotland
Francis,_Duke_of_Saxe-Coburg-Saalfeld	hasChild	Leopold_I_of_Belgium
Maximilian_II,_Holy_Roman_Emperor	hasChild	Matthias,_Holy_Roman_Emperor
John_of_England	isMarriedTo	Isabella_of_Angoulême
George,_Duke_of_Brunswick-Lüneburg	hasChild	George_William,_Duke_of_Brunswick-Lüneburg
Maria_Luisa_of_Parma	hasChild	Carlota_Joaquina_of_Spain
Elisabeth_Christine_of_Brunswick-Wolfenbüttel	hasChild	Maria_Amalia_of_Austria
Frederick_III,_German_Emperor	hasChild	Prince_Henry_of_Prussia_(1862–1929)
Kay_Johnson	hasChild	James_Cromwell
Robert_Stephens	isMarriedTo	Maggie_Smith
George_Washington	hasChild	John_Adams
Agnes_of_Courtenay	hasChild	Sibylla,_Queen_of_Jerusalem
George_III_of_the_United_Kingdom	hasChild	Ernest_Augustus_I_of_Hanover
Wilhelm_II_of_Germany	hasChild	Prince_Adalbert_of_Prussia_(1884–1948)
Ryan_O'Neal	isMarriedTo	Joanna_Moore
Philip_William,_Elector_Palatine	isMarriedTo	Landgravine_Elisabeth_Amalie_of_Hesse-Darmstadt
Augustus_III_of_Poland	isMarriedTo	Maria_Josepha_of_Austria
Pierre_Curie	hasChild	Ève_Curie
Augusta_of_Saxe-Weimar-Eisenach	hasChild	Frederick_III,_German_Emperor
Cecily_Neville,_Duchess_of_York	isMarriedTo	Richard_of_York,_3rd_Duke_of_York
Guy_of_Lusignan	isMarriedTo	Sibylla,_Queen_of_Jerusalem
Bona_Sforza	hasChild	Sigismund_II_Augustus
Violant_of_Hungary	isMarriedTo	James_I_of_Aragon
Christina_of_Saxony	hasChild	Isabella_of_Austria
Henry_I_of_England	isMarriedTo	Matilda_of_Scotland
Christopher_of_Bavaria	isMarriedTo	Dorothea_of_Brandenburg
fr/Silvano_Ribeiro	hasChild	Adelino_da_Palma_Carlos
Prince_Ferdinand_Philippe,_Duke_of_Orléans	isMarriedTo	Duchess_Helene_of_Mecklenburg-Schwerin
Julia_the_Elder	isMarriedTo	Marcus_Vipsanius_Agrippa
Prince_Carlos_of_Bourbon-Two_Sicilies	hasChild	Princess_María_de_las_Mercedes_of_Bourbon-Two_Sicilies
Isabella_Clara_Eugenia	isMarriedTo	Albert_VII,_Archduke_of_Austria
Maria_Feodorovna_(Sophie_Dorothea_of_Württemberg)	hasChild	Anna_Pavlovna_of_Russia
Charles_VI_of_France	isMarriedTo	Isabeau_of_Bavaria
Jacquetta_of_Luxembourg	hasChild	Elizabeth_Woodville
Ulrika_Eleonora_of_Denmark	isMarriedTo	Charles_XI_of_Sweden
Philip_of_Swabia	isMarriedTo	Irene_Angelina
Oskar_Lafontaine	hasChild	Hans_Eichel
Oscar_II_of_Sweden	hasChild	Haakon_VII_of_Norway
Amadeo_I_of_Spain	hasChild	Alfonso_XII_of_Spain
Christian_II_of_Denmark	hasChild	Gustav_I_of_Sweden
Frederick_III_of_Denmark	hasChild	Ulrika_Eleonora_of_Denmark
Maria_Christina_of_the_Two_Sicilies	hasChild	Infanta_Luisa_Fernanda,_Duchess_of_Montpensier
Eleanor_of_Provence	hasChild	Beatrice_of_England
Henry_II,_Count_of_Champagne	hasChild	Amalric_II_of_Jerusalem
Abigail_Adams	isMarriedTo	John_Adams
Gustav_I_of_Sweden	hasChild	John_III_of_Sweden
John,_King_of_England	isMarriedTo	Isabella_of_Angoulême
Prince_Bernhard_of_Lippe-Biesterfeld	hasChild	Princess_Margriet_of_the_Netherlands
Astrid_of_Sweden	isMarriedTo	Leopold_III_of_Belgium
Soong_May-ling	hasChild	Chiang_Ching-kuo
Margaret_Leijonhufvud	isMarriedTo	Gustav_I_of_Sweden
Sigrid_the_Haughty	hasChild	Estrid_Svendsdatter
Jean-Louis_Borloo	hasChild	Éric_Besson
Prince_Philip,_Duke_of_Edinburgh	hasChild	Prince_Edward,_Earl_of_Wessex
Benigno_Aquino,_Jr.	hasChild	Benigno_Aquino_III
Bona_of_Savoy	isMarriedTo	Galeazzo_Maria_Sforza
Gertrude_Vanderbilt_Whitney	isMarriedTo	Harry_Payne_Whitney
Joanna_of_Castile	hasChild	Charles_V,_Holy_Roman_Emperor
Blanche_of_Castile	hasChild	Louis_IX_of_France
Philip_III_of_Spain	isMarriedTo	Margaret_of_Austria,_Queen_of_Spain
Victoria_Eugenie_of_Battenberg	isMarriedTo	Alfonso_XIII_of_Spain
Frederick_II,_Holy_Roman_Emperor	isMarriedTo	Isabella_of_England
Maria_Theresa	isMarriedTo	Francis_I,_Holy_Roman_Emperor
Landgravine_Friederike_of_Hesse-Darmstadt	hasChild	Louise_of_Mecklenburg-Strelitz
Emma_of_Normandy	hasChild	Eleanor_of_Aquitaine
Adelaide_of_Austria	isMarriedTo	Victor_Emmanuel_II_of_Italy
Margaret_of_Brabant	hasChild	Elizabeth_of_Bohemia_(1292–1330)
Barbara_Bush	hasChild	Jeb_Bush
Charlotte_of_Mecklenburg-Strelitz	hasChild	George_IV_of_the_United_Kingdom
Robert_II_of_France	hasChild	Adèle_of_France,_Countess_of_Flanders
Kalākua_Kaheiheimālie	hasChild	Kīnaʻu
Philip_I_of_Castile	hasChild	Ferdinand_I,_Holy_Roman_Emperor
Gertrude_of_Hohenburg	hasChild	Albert_I_of_Germany
Queen_Silvia_of_Sweden	hasChild	Princess_Victoria_of_Sweden
Jennifer_Jones	hasChild	Robert_Walker,_Jr.
María_Isabella_of_Spain	hasChild	Teresa_Cristina_of_the_Two_Sicilies
Agnes_of_Antioch	isMarriedTo	Béla_III_of_Hungary
Joseph_P._Kennedy,_Sr.	hasChild	Eunice_Kennedy_Shriver
Clementine_Churchill,_Baroness_Spencer-Churchill	hasChild	Sarah_Churchill_(actress)
Beatrix_of_the_Netherlands	hasChild	Willem-Alexander_of_the_Netherlands
Alfonso_XIII_of_Spain	isMarriedTo	Victoria_Eugenie_of_Battenberg
Maximilian_I_Joseph_of_Bavaria	hasChild	Caroline_Augusta_of_Bavaria
Maria_Josepha_of_Austria	hasChild	Maria_Amalia_of_Saxony
Eleanor_of_Provence	hasChild	Edward_I_of_England
Ferdinand_Maria,_Elector_of_Bavaria	hasChild	Maximilian_II_Emanuel,_Elector_of_Bavaria
Louis_XII_of_France	hasChild	Claude_of_France
Rose_Kennedy	hasChild	Kathleen_Cavendish,_Marchioness_of_Hartington
Louise_of_Hesse-Kassel	hasChild	Louise_of_Sweden
Shirley_Jones	hasChild	David_Cassidy
Mary_Tudor,_Queen_of_France	isMarriedTo	Louis_XII_of_France
Peter_I,_Duke_of_Bourbon	hasChild	Joanna_of_Bourbon
Kīnaʻu	hasChild	Kamehameha_IV
Joanna_Shimkus	isMarriedTo	Sidney_Poitier
Isabella_I_of_Jerusalem	isMarriedTo	Amalric_II_of_Jerusalem
Countess_Augusta_Reuss_of_Ebersdorf	isMarriedTo	Francis,_Duke_of_Saxe-Coburg-Saalfeld
Ludwig_I_of_Bavaria	isMarriedTo	Therese_of_Saxe-Hildburghausen
Charles_II_of_Spain	isMarriedTo	Anne_Marie_Louise_d'Orléans,_Duchess_of_Montpensier
Hirohito	isMarriedTo	Empress_Kōjun
Ferdinand_I_of_Bulgaria	hasChild	Boris_III_of_Bulgaria
Elizabeth_of_Carinthia,_Queen_of_Germany	hasChild	Albert_II,_Duke_of_Austria
Adela_of_France,_Countess_of_Flanders	isMarriedTo	Baldwin_V,_Count_of_Flanders
Viviane_Reding	hasChild	Ján_Figeľ
Philip_V_of_Spain	hasChild	Maria_Antonia_Ferdinanda_of_Spain
Agnes_of_Courtenay	isMarriedTo	Amalric_I_of_Jerusalem
Louisa_Ulrika_of_Prussia	isMarriedTo	Adolf_Frederick_of_Sweden
Albert_II_of_Belgium	hasChild	Prince_Laurent_of_Belgium
Arlene_Dahl	isMarriedTo	Fernando_Lamas
Eleanor_of_Aragon,_Queen_of_Portugal	hasChild	Eleanor_of_Portugal,_Holy_Roman_Empress
William_IV,_Grand_Duke_of_Luxembourg	hasChild	Charlotte,_Grand_Duchess_of_Luxembourg
Elizabeth_of_York	hasChild	Catherine_of_Aragon
Henry_VIII_of_England	isMarriedTo	Catherine_Howard
Ottokar_I_of_Bohemia	isMarriedTo	Constance_of_Hungary
Adèle_of_Champagne	hasChild	Philip_II_of_France
Edward_I_of_England	hasChild	Edward_II_of_England
Ferdinand_II_of_the_Two_Sicilies	hasChild	Princess_Maria_Immaculata_of_Bourbon-Two_Sicilies_(1844–1899)
Bruce_Dern	hasChild	Laura_Dern
Philip_of_Swabia	hasChild	Maria_of_Swabia
Maria_Pia_of_Savoy	isMarriedTo	Luís_I_of_Portugal
Berenice_I_of_Egypt	hasChild	Arsinoe_II
John_III_Sobieski	isMarriedTo	Marie_Casimire_Louise_de_La_Grange_d'Arquien
Mary_de_Bohun	hasChild	Henry_V_of_England
Olof_Skötkonung	isMarriedTo	Yaroslav_the_Wise
Beatrice_of_Provence	hasChild	Charles_I_of_Naples
Louis_XIII_of_France	hasChild	Gaston,_Duke_of_Orléans
Wilhelm_II_of_Germany	hasChild	Wilhelm,_German_Crown_Prince
Princess_Henriette_Adelaide_of_Savoy	hasChild	Duchess_Maria_Anna_Victoria_of_Bavaria
Chiang_Kai-shek	hasChild	Chiang_Ching-kuo
Zulfikar_Ali_Bhutto	hasChild	Benazir_Bhutto
Princess_Joséphine_Charlotte_of_Belgium	hasChild	Maria_Teresa,_Grand_Duchess_of_Luxembourg
Isabella_of_Portugal,_Duchess_of_Burgundy	isMarriedTo	Philip_the_Good
Cherie_Blair	isMarriedTo	Tony_Blair
Marie_de'_Medici	isMarriedTo	Henry_IV_of_France
Rudolf_I_of_Germany	hasChild	Albert_I_of_Germany
Sigismund,_Holy_Roman_Emperor	isMarriedTo	Mary,_Queen_of_Hungary
Claudius	hasChild	Nero
Phoebe_Ephron	isMarriedTo	Henry_Ephron
Louis_XIII_of_France	hasChild	Philippe,_Duke_of_Orléans
Sigismund_III_Vasa	hasChild	John_II_Casimir_Vasa
Caroline_of_Baden	hasChild	Princess_Sophie_of_Bavaria
Corazon_Aquino	isMarriedTo	Benigno_Aquino,_Jr.
Benigno_Aquino,_Jr.	hasChild	Kris_Aquino
Joseph_P._Kennedy,_Sr.	hasChild	Kathleen_Cavendish,_Marchioness_of_Hartington
Maria_Theresa_of_Austria-Este,_Queen_of_Sardinia	hasChild	Princess_Maria_Teresa_of_Savoy
Kekūanāoa	hasChild	Keelikōlani
Jacques_Chirac	hasChild	Alain_Juppé
Philip_I,_Count_of_Flanders	isMarriedTo	Theresa_of_Portugal,_Countess_of_Flanders
Ernest_Augustus_I_of_Hanover	hasChild	George_V_of_Hanover
Therese_of_Saxe-Hildburghausen	hasChild	Luitpold,_Prince_Regent_of_Bavaria
John,_King_of_England	hasChild	Richard,_1st_Earl_of_Cornwall
Maria_Anna_of_Austria	hasChild	Mariana_Victoria_of_Spain
Henry_IV_of_England	hasChild	Humphrey_of_Lancaster,_1st_Duke_of_Gloucester
Princess_Maria_Antonietta_of_Bourbon-Two_Sicilies	isMarriedTo	Prince_Alfonso,_Count_of_Caserta
Elisabeth,_Duchess_of_Luxembourg	hasChild	Philip_the_Good
Maria_Carolina_of_Austria	hasChild	Francis_I_of_the_Two_Sicilies
Kīnaʻu	isMarriedTo	Kekūanāoa
Bonne_of_Bohemia	isMarriedTo	John_II_of_France
Maria_Christina_of_the_Two_Sicilies	hasChild	Francis,_Duke_of_Cádiz
Catherine_of_Valois	hasChild	Elizabeth_Woodville
Malcolm_III_of_Scotland	hasChild	Duncan_II_of_Scotland
Cleopatra_Thea	hasChild	Antiochus_IX_Cyzicenus
Ethelred_the_Unready	isMarriedTo	Emma_of_Normandy
Sonia_Gandhi	isMarriedTo	Rajiv_Gandhi
Grand_Duke_Konstantin_Nikolayevich_of_Russia	hasChild	Olga_Constantinovna_of_Russia
Nusrat_Bhutto	hasChild	Benazir_Bhutto
Queen_Paola_of_Belgium	isMarriedTo	Albert_II_of_Belgium
Margaret_of_Provence	hasChild	Philip_III_of_France
Isabeau_of_Bavaria	hasChild	Charles_VII_of_France
Alexander_II_of_Russia	isMarriedTo	Maria_Alexandrovna_(Marie_of_Hesse)
Frederick_V,_Elector_Palatine	isMarriedTo	Elizabeth_Stuart,_Queen_of_Bohemia
Jean,_Grand_Duke_of_Luxembourg	isMarriedTo	Princess_Joséphine_Charlotte_of_Belgium
Louise_of_Mecklenburg-Strelitz	hasChild	Frederick_William_IV_of_Prussia
Princess_Henrietta_of_Nassau-Weilburg	hasChild	Maria_Theresa_of_Austria_(1816–1867)
Maria_Theresa	hasChild	Maria_Christina,_Duchess_of_Teschen
Charles_VI,_Holy_Roman_Emperor	hasChild	Victor_Amadeus_II_of_Sardinia
Archduke_Franz_Karl_of_Austria	hasChild	Maximilian_I_of_Mexico
Bolesław_III_Wrymouth	hasChild	Władysław_II_the_Exile
John_of_Saxony	isMarriedTo	Amalie_Auguste_of_Bavaria
William_I_of_Sicily	hasChild	William_II_of_Sicily
Tony_Blair	hasChild	John_Major
Henry_II_of_England	hasChild	John_of_England
John_of_Bohemia	hasChild	Charles_IV,_Holy_Roman_Emperor
Anne_Marie_d'Orléans	isMarriedTo	Victor_Amadeus_II_of_Sardinia
Elizabeth_of_Bohemia_(1292–1330)	hasChild	Charles_IV,_Holy_Roman_Emperor
Philip_II_of_Spain	hasChild	Elizabeth_I_of_England
Joaquín_Almunia	hasChild	Olli_Rehn
Wilhelmine_of_Prussia,_Queen_of_the_Netherlands	isMarriedTo	William_I_of_the_Netherlands
Charlotte_of_Mecklenburg-Strelitz	hasChild	Ernest_Augustus_I_of_Hanover
Bertha_of_Holland	hasChild	Louis_VI_of_France
Bertrade_de_Montfort	hasChild	Adelaide_of_Maurienne
Ramon_Berenguer_IV,_Count_of_Provence	hasChild	Charles_I_of_Naples
Charles,_Duke_of_Orléans	hasChild	Louis_XII_of_France
Antipope_Felix_V	isMarriedTo	Mary_of_Burgundy
Charlotte,_Grand_Duchess_of_Luxembourg	hasChild	Jean,_Grand_Duke_of_Luxembourg
George_II_of_Great_Britain	hasChild	Louise_of_Great_Britain
Dulce_of_Aragon	hasChild	Afonso_II_of_Portugal
Eleanor_of_Aquitaine	hasChild	Isabella_of_Angoulême
Victor_Emmanuel_II_of_Italy	hasChild	Amadeo_I_of_Spain
Matilda_of_Flanders	hasChild	Henry_I_of_England
Princess_Märtha_of_Sweden	hasChild	Queen_Sonja_of_Norway
Carlo_Buonaparte	hasChild	Louis_Bonaparte
Sigismund_I_the_Old	hasChild	Anna_Jagiellon
Mary_of_Teck	hasChild	George_VI
Mary_Tudor,_Queen_of_France	hasChild	Frances_Grey,_Duchess_of_Suffolk
William,_Duke_of_Jülich-Cleves-Berg	isMarriedTo	Jeanne_d'Albret
Isabella_of_Angoulême	hasChild	Henry_III_of_England
Judith_of_Swabia	isMarriedTo	Władysław_I_Herman
Friedrich_Wilhelm,_Duke_of_Schleswig-Holstein-Sonderburg-Glücksburg	isMarriedTo	Princess_Louise_Caroline_of_Hesse-Kassel
Emma_of_Normandy	isMarriedTo	Cnut_the_Great
Albert,_Prince_Consort	hasChild	Princess_Alice_of_the_United_Kingdom
Meinhard,_Duke_of_Carinthia	hasChild	Henry_of_Bohemia
Wilhelmina_of_the_Netherlands	hasChild	William_Ernest,_Grand_Duke_of_Saxe-Weimar-Eisenach
Kīnaʻu	isMarriedTo	Kamehameha_II
Henri,_Count_of_Paris	isMarriedTo	Princess_Isabelle_of_Orléans-Braganza
Claudius	isMarriedTo	Agrippina_the_Younger
Louise_of_Mecklenburg-Strelitz	hasChild	Prince_Charles_of_Prussia
Ferdinand_Maria,_Elector_of_Bavaria	hasChild	Duchess_Maria_Anna_Victoria_of_Bavaria
Ferdinand_Maria,_Elector_of_Bavaria	isMarriedTo	Princess_Henriette_Adelaide_of_Savoy
Martha_Washington	isMarriedTo	George_Washington
George_V_of_the_United_Kingdom	hasChild	Edward_VIII_of_the_United_Kingdom
Elizabeth_of_Carinthia,_Queen_of_Germany	hasChild	Rudolf_I_of_Bohemia
Countess_Palatine_Caroline_of_Zweibrücken	isMarriedTo	Louis_IX,_Landgrave_of_Hesse-Darmstadt
Maria_of_Aragon,_Queen_of_Portugal	hasChild	Henry,_King_of_Portugal
Prince_Philip,_Duke_of_Edinburgh	hasChild	Prince_Andrew,_Duke_of_York
Marie_Jeanne_Baptiste_of_Savoy-Nemours	hasChild	Victor_Amadeus_II_of_Sardinia
Elisabeth_Farnese	hasChild	Mariana_Victoria_of_Spain
Isabella_Clara_Eugenia	hasChild	Maria_Theresa_of_Austria
Charles_VI,_Holy_Roman_Emperor	hasChild	Maria_Theresa
Elizabeth_of_York	hasChild	Mary_Tudor,_Queen_of_France
Maria_Theresa_of_Austria	hasChild	Ferdinand,_Duke_of_Breisgau
Eleanor_of_Portugal,_Holy_Roman_Empress	isMarriedTo	Frederick_III,_Holy_Roman_Emperor
Lothar_Bisky	hasChild	Gesine_Lötzsch
Maria_Luisa_of_Parma	hasChild	Ferdinand_VII_of_Spain
Constantine_the_Great	hasChild	Constantius_II
Peter_III_of_Aragon	hasChild	Elizabeth_of_Aragon
Maria_Theresa_of_Austria_(1816–1867)	hasChild	Prince_Alfonso,_Count_of_Caserta
Friedrich_III_of_Germany	hasChild	Prince_Henry_of_Prussia_(1862–1929)
Tadj_ol-Molouk	hasChild	Mohammad_Reza_Pahlavi
Antoine_of_Navarre	hasChild	Henry_IV_of_France
Ernest_Augustus,_Duke_of_Brunswick	hasChild	Frederica_of_Hanover
George_VI	hasChild	Princess_Margaret,_Countess_of_Snowdon
Jacques_Chirac	hasChild	Nicolas_Sarkozy
Sonia_Gandhi	hasChild	Rahul_Gandhi
Albert,_Prince_Consort	hasChild	Edward_VII_of_the_United_Kingdom
Frederick_William_III_of_Prussia	hasChild	Alexandra_Feodorovna_(Charlotte_of_Prussia)
Alexandra_of_Denmark	hasChild	Mary_of_Teck
John_Barrymore	isMarriedTo	Dolores_Costello
Leopold_I_of_Belgium	hasChild	Prince_Philippe,_Count_of_Flanders
Francis_I_of_Austria	hasChild	Maria_Leopoldina_of_Austria
Infanta_Marie_Anne_of_Portugal	hasChild	Charlotte,_Grand_Duchess_of_Luxembourg
Beatrice_I,_Countess_of_Burgundy	hasChild	Henry_VI,_Holy_Roman_Emperor
Viviane_Reding	hasChild	Neelie_Kroes
Odo_III,_Duke_of_Burgundy	hasChild	Hugh_IV,_Duke_of_Burgundy
Chulalongkorn	isMarriedTo	Savang_Vadhana
Rudolf_I_of_Germany	hasChild	Judith_of_Habsburg
Grand_Duchess_Anna_Pavlovna_of_Russia	isMarriedTo	William_II_of_the_Netherlands
Frederika_Louisa_of_Hesse-Darmstadt	hasChild	Wilhelmine_of_Prussia,_Queen_of_the_Netherlands
John_II_of_France	hasChild	Philip_I,_Duke_of_Burgundy
Eugène_de_Beauharnais	hasChild	Amélie_of_Leuchtenberg
Philip_VI_of_France	isMarriedTo	Joan_the_Lame
Charles,_Count_of_Valois	isMarriedTo	Margaret,_Countess_of_Anjou
Dolores_Costello	hasChild	John_Drew_Barrymore
Bill_Clinton	hasChild	Jim_Guy_Tucker
Randhir_Kapoor	hasChild	Karisma_Kapoor
Talal_of_Jordan	hasChild	Prince_Muhammad_bin_Talal
André_Rossinot	hasChild	Jean-Louis_Borloo
Princess_Ingeborg_of_Denmark	isMarriedTo	Prince_Carl,_Duke_of_Västergötland
Olga_Constantinovna_of_Russia	isMarriedTo	George_I_of_Greece
John_Quincy_Adams	hasChild	Andrew_Jackson
Joan_of_Valois,_Queen_of_Navarre	hasChild	Joan_of_Navarre,_Queen_of_England
Carl_XVI_Gustaf_of_Sweden	hasChild	Princess_Victoria_of_Sweden
Maria_Leopoldina_of_Austria	hasChild	Pedro_II_of_Brazil
Władysław_II_the_Exile	hasChild	Bolesław_I_the_Tall
Rajiv_Gandhi	isMarriedTo	Sonia_Gandhi
Isabella_II_of_Spain	hasChild	Alfonso_XII_of_Spain
Benazir_Bhutto	hasChild	Asif_Ali_Zardari
Napoleon	isMarriedTo	Joséphine_de_Beauharnais
Carlos_I_of_Portugal	isMarriedTo	Amélie_of_Orléans
Maximilian_I_Joseph_of_Bavaria	hasChild	Joachim_Murat
Philip_the_Good	hasChild	Charles_the_Bold
Francis_I_of_the_Two_Sicilies	isMarriedTo	María_Isabella_of_Spain
Ferdinand_II_of_Aragon	isMarriedTo	Germaine_of_Foix
Maria_Leopoldina_of_Austria	hasChild	Pedro_I_of_Brazil
F._W._de_Klerk	hasChild	Nelson_Mandela
George_W._Bush	isMarriedTo	Laura_Bush
Louis_IX,_Landgrave_of_Hesse-Darmstadt	isMarriedTo	Countess_Palatine_Caroline_of_Zweibrücken
Dwight_D._Eisenhower	isMarriedTo	Mamie_Eisenhower
Tadj_ol-Molouk	hasChild	Fawzia_Fuad_of_Egypt
Victor_Emmanuel_II_of_Savoy	hasChild	Princess_Maria_Clotilde_of_Savoy
Canute	isMarriedTo	Emma_of_Normandy
Alice_Claypoole_Gwynne	isMarriedTo	Cornelius_Vanderbilt_II
Henry_II,_Count_of_Champagne	hasChild	Isabella_I_of_Jerusalem
Philip_I,_Count_of_Boulogne	isMarriedTo	Matilda_II,_Countess_of_Boulogne
Peter_II_of_Portugal	isMarriedTo	Maria_Sophia_of_Neuburg
Hedwig_of_Kalisz	hasChild	Casimir_III_the_Great
Charles,_Count_of_Valois	hasChild	Blanche_of_Valois
Princess_Karoline_Mathilde_of_Schleswig-Holstein-Sonderburg-Augustenburg	hasChild	Princess_Helena_Adelaide_of_Schleswig-Holstein-Sonderburg-Glücksburg
Isabella_I_of_Jerusalem	isMarriedTo	Conrad_of_Montferrat
Louise_of_the_Netherlands	hasChild	Louise_of_Sweden
Ptolemy_I_Soter	hasChild	Arsinoe_II
Caroline_Augusta_of_Bavaria	isMarriedTo	Francis_I_of_Austria
Philip_I,_Count_of_Flanders	hasChild	Margaret_I,_Countess_of_Flanders
Agrippina_the_Younger	hasChild	Nero
Olli_Rehn	isMarriedTo	Ján_Figeľ
Cornelius_Vanderbilt_II	hasChild	Gertrude_Vanderbilt_Whitney
Napoleon	hasChild	Louis_XVIII_of_France
Darryl_F._Zanuck	isMarriedTo	Virginia_Fox
Henry_III_of_England	hasChild	Richard,_1st_Earl_of_Cornwall
Sweyn_I_of_Denmark	hasChild	Canute
Henry_III_of_England	hasChild	Edmund_Crouchback
Guy_of_Lusignan	hasChild	Amalric_II_of_Jerusalem
Maximilian_I,_Holy_Roman_Emperor	hasChild	Ferdinand_I,_Holy_Roman_Emperor
Prince_Carl,_Duke_of_Västergötland	isMarriedTo	Princess_Ingeborg_of_Denmark
Philip_I_of_Castile	isMarriedTo	Joanna_of_Castile
Charlotte,_Grand_Duchess_of_Luxembourg	isMarriedTo	Prince_Felix_of_Bourbon-Parma
Martha_Bulloch_Roosevelt	hasChild	Theodore_Roosevelt
Augusta_Victoria_of_Schleswig-Holstein	hasChild	Prince_Eitel_Friedrich_of_Prussia
Yolande_of_Aragon	hasChild	René_of_Anjou
Philip_IV_of_France	hasChild	Louis_X_of_France
Diane_Ladd	isMarriedTo	Bruce_Dern
Leopold_II,_Holy_Roman_Emperor	hasChild	Francis_I_of_Austria
Charles_III_of_Naples	hasChild	Mary,_Queen_of_Hungary
Blanche_of_Valois	isMarriedTo	Charles_IV,_Holy_Roman_Emperor
Conrad_II,_Holy_Roman_Emperor	isMarriedTo	Henry_I_of_France
Joan_I,_Countess_of_Auvergne	hasChild	Philip_I,_Duke_of_Burgundy
Countess_Palatine_Caroline_of_Zweibrücken	hasChild	Frederika_Louisa_of_Hesse-Darmstadt
Ferdinand,_Duke_of_Breisgau	hasChild	Charles_Frederick,_Grand_Duke_of_Baden
Lyndon_B._Johnson	hasChild	Hubert_Humphrey
Peter_III_of_Aragon	isMarriedTo	Constance_of_Sicily,_Queen_of_Aragon
Maria_Anna_of_Austria	hasChild	Peter_III_of_Portugal
Christian_IX_of_Denmark	hasChild	George_I_of_Greece
Juliana_of_the_Netherlands	isMarriedTo	Prince_Bernhard_of_the_Netherlands
Louis_XIII_of_France	isMarriedTo	Anne_of_Austria
Princess_Henrietta_of_Nassau-Weilburg	isMarriedTo	Archduke_Charles,_Duke_of_Teschen
Lolo_Soetoro	hasChild	Barack_Obama
Frederick_IX_of_Denmark	hasChild	Margrethe_II_of_Denmark
Ferdinand_I_of_Aragon	hasChild	Eleanor_of_Aragon,_Queen_of_Portugal
Ottokar_I_of_Bohemia	hasChild	Dagmar_of_Bohemia
Thomas_I,_Count_of_Savoy	hasChild	Thomas,_Count_of_Flanders
Talal_of_Jordan	isMarriedTo	Zein_al-Sharaf_Talal
Grand_Duke_Michael_Nikolaevich_of_Russia	isMarriedTo	Olga_Feodorovna_of_Baden
Infanta_Catherine_Michelle_of_Spain	hasChild	Emmanuel_Philibert,_Duke_of_Savoy
Colleen_Dewhurst	isMarriedTo	George_C._Scott
Leopold_III_of_Belgium	isMarriedTo	Lilian,_Princess_of_Réthy
Dalia_Grybauskaitė	hasChild	Algirdas_Butkevičius
Christian_IX_of_Denmark	hasChild	Maria_Feodorovna_(Dagmar_of_Denmark)
Otto_I,_Count_of_Savoy	hasChild	Bertha_of_Savoy
Eleanor_of_Austria	hasChild	Catherine_of_Medici
Mary_de_Bohun	isMarriedTo	Henry_IV_of_England
Joan_I_of_Navarre	hasChild	Isabella_of_France
Laura_Bush	isMarriedTo	George_W._Bush
Frederick_III_of_Denmark	hasChild	Prince_George_of_Denmark
Renate_Künast	hasChild	Horst_Seehofer
Marie_de'_Medici	hasChild	Louis_XIII_of_France
Philip_II_of_Spain	isMarriedTo	Elisabeth_of_Valois
Livia	hasChild	Tiberius
Thomas,_Count_of_Savoy	hasChild	Thomas,_Count_of_Flanders
Charles_III,_Duke_of_Lorraine	hasChild	Ferdinando_I_de'_Medici,_Grand_Duke_of_Tuscany
Dorothea_Maria_of_Anhalt	hasChild	Ernest_I,_Duke_of_Saxe-Gotha
John_III_Sobieski	hasChild	James_Louis_Sobieski
Friedrich_III_of_Germany	hasChild	Princess_Margaret_of_Prussia
Charles_VI,_Holy_Roman_Emperor	hasChild	Charles_III_of_Spain
George_II_of_Great_Britain	isMarriedTo	Caroline_of_Ansbach
Louisa_Ulrika_of_Prussia	hasChild	Charles_XIII_of_Sweden
Theresa_of_Portugal,_Countess_of_Flanders	hasChild	Margaret_I,_Countess_of_Flanders
Archduke_Ferdinand_Karl_Viktor_of_Austria-Este	isMarriedTo	Archduchess_Elisabeth_Franziska_of_Austria
Fernando_Lamas	hasChild	Lorenzo_Lamas
Caroline_of_Ansbach	isMarriedTo	George_II_of_Great_Britain
Gunhilda_of_Denmark	isMarriedTo	Henry_III,_Holy_Roman_Emperor
Frederick_I,_Margrave_of_Brandenburg-Ansbach	isMarriedTo	Sophia_Jagiellon,_Margravine_of_Brandenburg-Ansbach
Ferdinand_II_of_Aragon	hasChild	Joanna_of_Castile
Isabella_of_England	isMarriedTo	Frederick_II,_Holy_Roman_Emperor
Rajesh_Khanna	isMarriedTo	Dimple_Kapadia
Beatrice_of_Savoy	isMarriedTo	Ramon_Berenguer_IV,_Count_of_Provence
Henry_IV_of_England	hasChild	Henry_V_of_England
Béla_IV_of_Hungary	hasChild	Stephen_V_of_Hungary
Empress_Kōjun	hasChild	Empress_Michiko
Rudolf_I_of_Bohemia	hasChild	Henry_of_Bohemia
Frederick_William_III_of_Prussia	hasChild	William_I,_German_Emperor
Maria_Feodorovna_(Sophie_Dorothea_of_Württemberg)	hasChild	Alexander_I_of_Russia
Oskar_Lafontaine	hasChild	Klaus_Ernst
Joseph_I,_Holy_Roman_Emperor	hasChild	Maria_Amalia_of_Austria
Leopold_II,_Holy_Roman_Emperor	hasChild	Archduke_Rainer_Joseph_of_Austria
Philip_William,_Elector_Palatine	hasChild	Eleonor_Magdalene_of_Neuburg
Eleanor_Roosevelt	hasChild	James_Roosevelt
José_Baptista_Pinheiro_de_Azevedo	isMarriedTo	Francisco_da_Costa_Gomes
Maria_Theresa_of_Spain	isMarriedTo	Louis_XIV_of_France
Barbara_Hale	hasChild	William_Katt
Philip_William,_Elector_Palatine	hasChild	Maria_Sophia_of_Neuburg
Frederick_III,_Holy_Roman_Emperor	isMarriedTo	Eleanor_of_Portugal,_Holy_Roman_Empress
Sibylla_of_Anjou	hasChild	Philip_I,_Count_of_Flanders
Bertha_of_Holland	hasChild	Bertrade_de_Montfort
Ferdinand_II,_Holy_Roman_Emperor	hasChild	Frederick_V,_Elector_Palatine
Antoine_of_Navarre	isMarriedTo	Jeanne_d'Albret
Charles_V,_Holy_Roman_Emperor	hasChild	Margaret_of_Parma
Anne_of_Brittany	hasChild	Mary_Tudor,_Queen_of_France
Mary,_Queen_of_Hungary	hasChild	Charles_III_of_Naples
Fausta	isMarriedTo	Constantine_the_Great
Letizia_Ramolino	hasChild	Lucien_Bonaparte
Peter_the_Great	isMarriedTo	Ivan_V_of_Russia
Elisabetta_Farnese	hasChild	Charles_III_of_Spain
Henry_VIII_of_England	hasChild	Edward_VI_of_England
Cnut_the_Great	hasChild	Gunhilda_of_Denmark
Eleanor_of_Alburquerque	hasChild	Eleanor_of_Aragon,_Queen_of_Portugal
Eleonor_Magdalene_of_Neuburg	hasChild	Charles_VI,_Holy_Roman_Emperor
Agnes_of_Germany	isMarriedTo	Leopold_III,_Margrave_of_Austria
Eleanor_of_Alburquerque	hasChild	Maria_of_Castile,_Queen_of_Aragon
Boris_III_of_Bulgaria	hasChild	Simeon_Saxe-Coburg-Gotha
Charlotte_of_Mecklenburg-Strelitz	hasChild	Prince_Adolphus,_Duke_of_Cambridge
Maria_Theresa_of_Austria	hasChild	Leopold_II,_Holy_Roman_Emperor
John_II_of_France	hasChild	Philip_the_Bold
Thierry,_Count_of_Flanders	isMarriedTo	Sibylla_of_Anjou
Philip_I_of_Castile	hasChild	Joanna_of_Castile
Maria_Theresa_of_Austria-Este,_Queen_of_Sardinia	hasChild	Maria_Cristina_of_Savoy
Ferdinand_I_of_Aragon	hasChild	John_II_of_Aragon
Elizabeth_of_Poland,_Queen_of_Hungary	hasChild	Louis_I_of_Hungary
George_H._W._Bush	hasChild	Dan_Quayle
Sirimavo_Bandaranaike	hasChild	J._R._Jayewardene
Eleanor_of_Austria	isMarriedTo	Francis_I_of_France
Maximilian_II,_Holy_Roman_Emperor	hasChild	Anna_of_Austria,_Queen_of_Spain
Louise_of_Hesse-Kassel	hasChild	Princess_Thyra_of_Denmark
Ferdinand_I_of_Naples	isMarriedTo	Isabella_of_Clermont
Nicholas_I_of_Montenegro	hasChild	Peter_I_of_Serbia
Robert_Walker_(actor)	isMarriedTo	Jennifer_Jones
Princess_Louise_Caroline_of_Hesse-Kassel	isMarriedTo	Friedrich_Wilhelm,_Duke_of_Schleswig-Holstein-Sonderburg-Glücksburg
John_D._Rockefeller,_Jr.	hasChild	David_Rockefeller
Ferdinand_I_of_Naples	hasChild	Eleanor_of_Naples,_Duchess_of_Ferrara
Catherine_of_Medici	hasChild	Claude_of_Valois
Maureen_O'Sullivan	isMarriedTo	John_Farrow
Marie_of_Anjou	isMarriedTo	Charles_VII_of_France
Maximilian_I,_Holy_Roman_Emperor	hasChild	Charles_V,_Holy_Roman_Emperor
Henry_IV_of_France	isMarriedTo	Margaret_of_Valois
Charles_V,_Duke_of_Lorraine	isMarriedTo	Eleanor_of_Austria,_Queen_of_Poland
Archelaus_of_Cappadocia	hasChild	Cotys_IX
John_D._Rockefeller,_Jr.	isMarriedTo	Abby_Aldrich_Rockefeller
Archduchess_Elisabeth_Franziska_of_Austria	hasChild	Maria_Theresa_of_Austria-Este_(1849–1919)
Letizia_Ramolino	hasChild	Elisa_Bonaparte
Hedwig_of_Kalisz	hasChild	Elizabeth_of_Poland,_Queen_of_Hungary
Eleanor_of_Provence	hasChild	Edmund_Crouchback
Catherine_of_Medici	hasChild	Elisabeth_of_Valois
Sigismund,_Holy_Roman_Emperor	isMarriedTo	Barbara_of_Cilli
Sophie_Amalie_of_Brunswick-Lüneburg	hasChild	Ulrika_Eleonora_of_Denmark
Thabo_Mbeki	hasChild	Jacob_Zuma
Stephen_of_England	hasChild	Empress_Matilda
Frederika_Louisa_of_Hesse-Darmstadt	hasChild	Prince_Charles_of_Prussia
Louis_XI_of_France	hasChild	Joan_of_France,_Duchess_of_Berry
Marie_Henriette_of_Austria	isMarriedTo	Leopold_II_of_Belgium
Maximilian_I,_Holy_Roman_Emperor	isMarriedTo	Bianca_Maria_Sforza
Luís_I_of_Portugal	hasChild	Carlos_I_of_Portugal
Edward_III_of_England	hasChild	John_of_Gaunt,_1st_Duke_of_Lancaster
Victoria_of_Baden	hasChild	Princess_Margaret_of_Connaught
Prince_Bernhard_of_Lippe-Biesterfeld	hasChild	Princess_Irene_of_the_Netherlands
Thierry,_Count_of_Flanders	hasChild	Margaret_I,_Countess_of_Flanders
Eleanor_of_Aquitaine	hasChild	John_of_England
Archduchess_Louise_of_Austria	isMarriedTo	Frederick_Augustus_III_of_Saxony
Elisabeth_of_France_(1602–1644)	hasChild	Luisa_de_Guzmán
Eleanor_of_Aragon,_Queen_of_Portugal	hasChild	Ferdinand,_Duke_of_Viseu
George_I_of_Greece	isMarriedTo	Olga_Constantinovna_of_Russia
John_III_of_Sweden	isMarriedTo	Catherine_Jagiellon
Franklin_D._Roosevelt	hasChild	James_Roosevelt
Pythodorida_of_Pontus	isMarriedTo	Polemon_I_of_Pontus
Tiberius	isMarriedTo	Julia_the_Elder
Marie_of_Anjou	hasChild	Charlotte_of_Savoy
Joanna,_Duchess_of_Brabant	isMarriedTo	Wenceslaus_I,_Duke_of_Luxembourg
Louis_VIII_of_France	hasChild	Charles_I_of_Naples
Philip_of_Swabia	hasChild	Frederick_II,_Holy_Roman_Emperor
Catherine_Parr	hasChild	Anne_of_Denmark
Charles_IV_of_Spain	hasChild	María_Isabella_of_Spain
Jobst_of_Moravia	hasChild	Louis_I,_Duke_of_Orléans
Maria_Feodorovna_(Sophie_Dorothea_of_Württemberg)	hasChild	Catherine_Pavlovna_of_Russia
Oskar_Lafontaine	isMarriedTo	Lothar_Bisky
Philip_William,_Elector_Palatine	hasChild	Johann_Wilhelm,_Elector_Palatine
John_Adams	isMarriedTo	Abigail_Adams
Charles_VI,_Holy_Roman_Emperor	hasChild	Charles_VII,_Holy_Roman_Emperor
Ramon_Berenguer_IV,_Count_of_Provence	hasChild	Eleanor_of_Provence
Paul_I_of_Russia	hasChild	Nicholas_I_of_Russia
Eleanor_of_Toledo	isMarriedTo	Cosimo_I_de'_Medici,_Grand_Duke_of_Tuscany
Sunil_Dutt	hasChild	Sanjay_Dutt
Sophie_of_Mecklenburg-Güstrow	hasChild	Anne_of_Denmark
Louise_of_the_Netherlands	hasChild	Sophia_of_Nassau
Blanche_I_of_Navarre	isMarriedTo	John_II_of_Aragon
Frederick_William_II_of_Prussia	hasChild	Frederick_William_III_of_Prussia
Charles_III,_Duke_of_Parma	isMarriedTo	Louise_Marie_Thérèse_d'Artois
Odo_III,_Duke_of_Burgundy	isMarriedTo	Afonso_I_of_Portugal
Maria_Christina_of_Austria	isMarriedTo	Alfonso_XII_of_Spain
Corazon_Aquino	hasChild	Benigno_Aquino_III
Victor_Emmanuel_II_of_Italy	hasChild	Princess_Maria_Clotilde_of_Savoy
Carlo_Buonaparte	hasChild	Caroline_Bonaparte
Urraca_of_Castile,_Queen_of_Portugal	isMarriedTo	Afonso_II_of_Portugal
Victoria_of_Baden	hasChild	Prince_Wilhelm,_Duke_of_Södermanland
Maria_Amalia_of_Saxony	hasChild	Maria_Luisa_of_Spain
Queen_Sonja_of_Norway	isMarriedTo	Harald_V_of_Norway
Frederick_VIII_of_Denmark	hasChild	Christian_X_of_Denmark
Elisabeth_of_France_(1602–1644)	isMarriedTo	Philip_IV_of_Spain
Henry_X,_Duke_of_Bavaria	isMarriedTo	Gertrude_of_Süpplingenburg
Ferdinand_II_of_the_Two_Sicilies	hasChild	Princess_Maria_Annunciata_of_Bourbon-Two_Sicilies
Philip_VI_of_France	hasChild	John_II_of_France
Maria_Theresa_of_Austria-Este,_Queen_of_Sardinia	hasChild	Maria_Beatrice_of_Savoy
Maximilian_I_Joseph_of_Bavaria	isMarriedTo	Princess_Augusta_Wilhelmine_of_Hesse-Darmstadt
Claude_of_France	hasChild	Eleanor_of_Austria
Hillary_Rodham_Clinton	hasChild	Chelsea_Clinton
Augustus_III_of_Poland	hasChild	Maria_Amalia_of_Saxony
Emperor_Taishō	hasChild	Hirohito
Sophia_of_Nassau	hasChild	Prince_Carl,_Duke_of_Västergötland
Adelaide_of_Maurienne	isMarriedTo	Louis_VI_of_France
Philip_V_of_Spain	hasChild	Louis_I_of_Spain
Louis,_Duke_of_Savoy	hasChild	Philip_II,_Duke_of_Savoy
Gerald_Ford	isMarriedTo	Betty_Ford
Mumtaz_Mahal	isMarriedTo	Shah_Jahan
Roberto_Rossellini	isMarriedTo	Ingrid_Bergman
Margaret_of_Geneva	isMarriedTo	Thomas_I,_Count_of_Savoy
Anne_of_Brittany	hasChild	Joan_of_France,_Duchess_of_Berry
Manfred,_King_of_Sicily	hasChild	Charles_I_of_Naples
Sigismund_III_Vasa	hasChild	Charles_IX_of_Sweden
Ján_Figeľ	hasChild	Viviane_Reding
Maria_Theresa_of_Austria	hasChild	Maria_Christina,_Duchess_of_Teschen
Grand_Duchess_Anna_Pavlovna_of_Russia	hasChild	Sophie_of_Württemberg
Rozala_of_Italy	hasChild	Baldwin_IV,_Count_of_Flanders
Albert,_Prince_Consort	hasChild	Edward_VII
Alexandra_Feodorovna_(Charlotte_of_Prussia)	hasChild	Maria_Alexandrovna_(Marie_of_Hesse)
Carlos_Galvão_de_Melo	isMarriedTo	Francisco_da_Costa_Gomes
Philippe_II,_Duke_of_Orléans	hasChild	Louis_d'Orléans,_Duke_of_Orléans
Constance,_Queen_of_Sicily	hasChild	Frederick_II,_Holy_Roman_Emperor
Ahmose-Nefertari	isMarriedTo	Ahmose_I
Kalākua_Kaheiheimālie	isMarriedTo	Kamehameha_I
Henry_VII,_Holy_Roman_Emperor	isMarriedTo	Margaret_of_Brabant
Charles_Frederick,_Grand_Duke_of_Saxe-Weimar-Eisenach	isMarriedTo	Grand_Duchess_Maria_Pavlovna_of_Russia_(1786–1859)
Louis_VI_of_France	hasChild	Robert_I,_Count_of_Dreux
Josephine_of_Leuchtenberg	hasChild	Louise_of_the_Netherlands
Albert_I_of_Germany	hasChild	Albert_II,_Duke_of_Austria
Agnes_of_Antioch	hasChild	Constance_of_Hungary
Kunigunda_of_Halych	hasChild	Judith_of_Habsburg
Philip_I,_Duke_of_Burgundy	isMarriedTo	Margaret_III,_Countess_of_Flanders
John,_King_of_England	hasChild	Henry_III_of_England
Philip_I_of_France	isMarriedTo	Bertrade_de_Montfort
Ingrid_of_Sweden	hasChild	Margrethe_II_of_Denmark
Anne_of_Austria,_Queen_of_Poland	hasChild	Christina_of_Holstein-Gottorp
Ingegerd_Olofsdotter_of_Sweden	isMarriedTo	Yaroslav_the_Wise
Maria_Feodorovna_(Sophie_Dorothea_of_Württemberg)	hasChild	Grand_Duke_Constantine_Pavlovich_of_Russia
Elizabeth_of_Carinthia,_Queen_of_Germany	hasChild	Frederick_the_Fair
John_V,_Duke_of_Brittany	isMarriedTo	Joan_of_Navarre,_Queen_of_England
Charles_Emmanuel_II,_Duke_of_Savoy	isMarriedTo	Marie_Jeanne_Baptiste_of_Savoy-Nemours
Charles_XI_of_Sweden	hasChild	Ulrika_Eleonora,_Queen_of_Sweden
Maria_Sophia_of_Neuburg	hasChild	John_V_of_Portugal
Ivan_V_of_Russia	isMarriedTo	Peter_the_Great
Charles_IV,_Holy_Roman_Emperor	hasChild	John_Henry,_Margrave_of_Moravia
Marie_Louise,_Duchess_of_Parma	hasChild	Margherita_of_Savoy
Leopold_III,_Margrave_of_Austria	hasChild	Henry_II,_Duke_of_Austria
Margherita_of_Savoy	hasChild	Vittorio_Emanuele_III
Marie_Jeanne_Baptiste_of_Savoy-Nemours	isMarriedTo	Charles_V,_Duke_of_Lorraine
Charles_V,_Holy_Roman_Emperor	hasChild	Maria_of_Austria,_Holy_Roman_Empress
Galeazzo_Maria_Sforza	hasChild	Caterina_Sforza
Margaret_of_Provence	hasChild	Isabella_of_Aragon
Duke_Henry_of_Mecklenburg-Schwerin	hasChild	Juliana_of_the_Netherlands
Françoise_d'Aubigné,_Marquise_de_Maintenon	isMarriedTo	Louis_XIV_of_France
Henry_III_of_England	hasChild	Beatrice_of_England
Gertrude_of_Süpplingenburg	hasChild	Henry_the_Lion
Francis_I_of_the_Two_Sicilies	hasChild	Ferdinand_II_of_the_Two_Sicilies
Ferdinand_I_of_the_Two_Sicilies	isMarriedTo	Maria_Carolina_of_Austria
Maria_Josepha_of_Austria	hasChild	Frederick_Christian,_Elector_of_Saxony
Sophia_of_Prussia	isMarriedTo	Constantine_I_of_Greece
John_F._Kennedy	hasChild	Caroline_Kennedy
Leopold_I,_Holy_Roman_Emperor	hasChild	Charles_VI,_Holy_Roman_Emperor
Charles_I_of_Naples	hasChild	Charles_II_of_Naples
Louise_of_Mecklenburg-Strelitz	hasChild	Alexandra_Feodorovna_(Charlotte_of_Prussia)
Stephen,_King_of_England	isMarriedTo	Matilda_of_Boulogne
Catherine_Howard	hasChild	Catherine_Parr
Frederick_I_of_Prussia	hasChild	Frederick_William_I_of_Prussia
Philippa_of_Lancaster	hasChild	Isabella_of_Portugal,_Duchess_of_Burgundy
Nicholas_I_of_Montenegro	hasChild	Princess_Milica_of_Montenegro
Sweyn_Forkbeard	hasChild	Cnut_the_Great
George,_Duke_of_Brunswick-Lüneburg	hasChild	Sophie_Amalie_of_Brunswick-Lüneburg
Polemon_I_of_Pontus	hasChild	Antonia_Tryphaena
Ingrid_Bergman	isMarriedTo	Roberto_Rossellini
Odo_III,_Duke_of_Burgundy	isMarriedTo	Theresa_of_Portugal,_Countess_of_Flanders
Dorothea_of_Saxe-Lauenburg	hasChild	Frederick_II_of_Denmark
Princess_Marie_Louise_of_Bourbon-Parma	isMarriedTo	Ferdinand_I_of_Bulgaria
Octavia_the_Younger	isMarriedTo	Mark_Antony
Wenceslaus_II_of_Bohemia	isMarriedTo	Judith_of_Habsburg
John_of_Lancaster,_1st_Duke_of_Bedford	isMarriedTo	Jacquetta_of_Luxembourg
Lucille_Ball	isMarriedTo	Desi_Arnaz
Hildegard_of_Vinzgouw	isMarriedTo	Charlemagne
Astrid_of_Sweden	hasChild	Albert_II_of_Belgium
Joan_I_of_Navarre	hasChild	Charles_IV_of_France
François_Mitterrand	isMarriedTo	Danielle_Mitterrand
Isabelle_of_Hainaut	hasChild	Agnes_of_Merania
Judy_Garland	isMarriedTo	Vincente_Minnelli
Charles_IV,_Holy_Roman_Emperor	hasChild	Wenceslaus_IV_of_Bohemia
Martin_I_of_Sicily	hasChild	Martin_of_Aragon
Anne_of_Cyprus	hasChild	Bona_of_Savoy
Sigismund_I_the_Old	hasChild	Catherine_Jagiellon
Alexandrine_of_Mecklenburg-Schwerin	hasChild	Ingrid_of_Sweden
Louis_IX_of_France	isMarriedTo	Margaret_of_Provence
Milena_Vukotić	isMarriedTo	Nicholas_I_of_Montenegro
Mary_de_Bohun	hasChild	John_of_Lancaster,_1st_Duke_of_Bedford
Elizabeth_of_York	hasChild	Henry_VIII_of_England
Philip_V_of_Spain	hasChild	Maximilian_II_Emanuel,_Elector_of_Bavaria
Augusta_Victoria_of_Schleswig-Holstein	hasChild	Prince_Joachim_of_Prussia
Sophie_of_Mecklenburg-Güstrow	isMarriedTo	Frederick_II_of_Denmark
Rudolf_I_of_Bohemia	hasChild	Frederick_the_Fair
Mariana_of_Austria	hasChild	Charles_II_of_Spain
Gustav_I_of_Sweden	isMarriedTo	Margaret_Leijonhufvud
Kekūanāoa	isMarriedTo	Kīnaʻu
Catherine_of_Valois	isMarriedTo	Henry_V_of_England
Peter_III_of_Portugal	hasChild	Infanta_Maria_Ana_Vitória_of_Portugal
Dwight_D._Eisenhower	hasChild	John_Eisenhower
Christian_II_of_Denmark	hasChild	Christina_of_Denmark
Ann_Dunham	hasChild	Barack_Obama
Charles_IV,_Holy_Roman_Emperor	isMarriedTo	Blanche_of_Valois
Mary_I_of_England	isMarriedTo	Philip_II_of_Spain
Philip_III_of_Navarre	hasChild	Charles_II_of_Navarre
Blythe_Danner	hasChild	Gwyneth_Paltrow
Paul_of_Greece	hasChild	Constantine_II_of_Greece
Louis_XII_of_France	isMarriedTo	Joan_of_France,_Duchess_of_Berry
Empress_Matilda	hasChild	Stephen_of_England
Charles_I_of_England	hasChild	Charles_II_of_England
Mary_of_Burgundy	isMarriedTo	Antipope_Felix_V
Polemon_I_of_Pontus	isMarriedTo	Pythodorida_of_Pontus
Jean-Louis_Borloo	hasChild	Xavier_Bertrand
Kapaakea	hasChild	Kalākaua
Anne_of_Austria,_Queen_of_Poland	hasChild	Władysław_IV_Vasa
Ozzy_Osbourne	hasChild	Kelly_Osbourne
John_the_Fearless	isMarriedTo	Margaret_of_Bavaria
Abby_Aldrich_Rockefeller	hasChild	Laurance_Rockefeller
Teresa_Cristina_of_the_Two_Sicilies	isMarriedTo	Pedro_II_of_Brazil
Casimir_III_of_Poland	hasChild	Louis_I_of_Hungary
Judith_of_Habsburg	isMarriedTo	Wenceslaus_II_of_Bohemia
Sunil_Dutt	isMarriedTo	Nargis
Friedrich_Ferdinand,_Duke_of_Schleswig-Holstein	hasChild	Princess_Helena_Adelaide_of_Schleswig-Holstein-Sonderburg-Glücksburg
Sharon_Osbourne	isMarriedTo	Ozzy_Osbourne
Alexander_III_of_Russia	hasChild	Grand_Duke_Michael_Alexandrovich_of_Russia
Richard_Nixon	hasChild	Lyndon_B._Johnson
Jacqueline,_Countess_of_Hainaut	hasChild	Isabella_of_Portugal,_Duchess_of_Burgundy
Rudolf_I_of_Bohemia	isMarriedTo	Elizabeth_Richeza_of_Poland
Constantine_the_Great	isMarriedTo	Fausta
Laura_Bush	hasChild	Michelle_Obama
Anne_Eleonore_of_Hesse-Darmstadt	hasChild	George_William,_Duke_of_Brunswick-Lüneburg
Augustus_III_of_Poland	hasChild	Charles_of_Saxony,_Duke_of_Courland
Irene_Angelina	hasChild	Elisabeth_of_Swabia
Leopold_I,_Holy_Roman_Emperor	isMarriedTo	Eleonor_Magdalene_of_Neuburg
Rajiv_Gandhi	hasChild	Rahul_Gandhi
Franz_Joseph_I_of_Austria	isMarriedTo	Empress_Elisabeth_of_Austria
Elizabeth_Rees-Williams	isMarriedTo	Richard_Harris
Caroline_of_Ansbach	hasChild	Louise_of_Great_Britain
Richard_Harris	isMarriedTo	Elizabeth_Rees-Williams
Maria_Laskarina	isMarriedTo	Béla_IV_of_Hungary
Amalia_of_Oldenburg	hasChild	Olga_Constantinovna_of_Russia
Jeanne_d'Albret	isMarriedTo	Antoine_of_Navarre
Henry_VI,_Holy_Roman_Emperor	hasChild	Philip_of_Swabia
Elisabeth_Farnese	hasChild	Maria_Antonia_Ferdinanda_of_Spain
Ahmose-Nefertari	hasChild	Amenhotep_I
Stephen,_King_of_England	hasChild	William_I,_Count_of_Boulogne
Henry_IV_of_France	hasChild	César,_Duke_of_Vendôme
Germanicus	hasChild	Caligula
Archduchess_Elisabeth_Franziska_of_Austria	isMarriedTo	Archduke_Karl_Ferdinand_of_Austria
Manuel_I_of_Portugal	hasChild	Isabella_of_Portugal
Frederick_II_of_Denmark	hasChild	Anne_of_Denmark
Eleanor_of_Aquitaine	isMarriedTo	Richard_I_of_England
Ottokar_II_of_Bohemia	hasChild	Albert_I_of_Germany
Pedro_I_of_Brazil	hasChild	Maria_II_of_Portugal
Rose_Kennedy	isMarriedTo	Joseph_P._Kennedy,_Sr.
George,_Duke_of_Brunswick-Lüneburg	hasChild	Ernest_Augustus,_Elector_of_Brunswick-Lüneburg
Isabella_of_Aragon	isMarriedTo	Philip_III_of_France
Philip_IV_of_Spain	isMarriedTo	Elisabeth_of_France_(1602–1644)
Princess_Marie_Louise_of_Bourbon-Parma	hasChild	Boris_III_of_Bulgaria
Eleanor_of_Toledo	hasChild	Francesco_I_de'_Medici,_Grand_Duke_of_Tuscany
Ptolemy_I_Soter	hasChild	Ptolemy_II_Philadelphus
Margaret_I,_Countess_of_Flanders	isMarriedTo	Baldwin_V,_Count_of_Hainaut
Landgravine_Elisabeth_Amalie_of_Hesse-Darmstadt	hasChild	Charles_III_Philip,_Elector_Palatine
Albert_I_of_Belgium	hasChild	Leopold_III_of_Belgium
Siim_Kallas	hasChild	Andrus_Ansip
Francis_I_of_Austria	hasChild	Ferdinand_I_of_Austria
Alexandra_of_Denmark	hasChild	George_V
Maria_Luisa_of_Parma	hasChild	María_Isabella_of_Spain
Emma_of_Normandy	isMarriedTo	Ethelred_the_Unready
Zein_al-Sharaf_Talal	isMarriedTo	Talal_of_Jordan
Charlotte_of_Savoy	hasChild	Charles_VIII_of_France
Dharmendra	hasChild	Sunny_Deol
Caroline_of_Baden	hasChild	Amalie_Auguste_of_Bavaria
Marie_Thérèse_of_Austria	isMarriedTo	Louis_XIV_of_France
Oscar_I_of_Sweden	hasChild	Charles_XV_of_Sweden
Frederick_I,_Holy_Roman_Emperor	hasChild	Otto_I,_Count_of_Burgundy
Francis_I,_Holy_Roman_Emperor	hasChild	Archduchess_Maria_Amalia_of_Austria
Maria_Josepha_of_Saxony,_Dauphine_of_France	hasChild	Charles_X_of_France
Philippa_of_Hainault	hasChild	Edmund_of_Langley,_1st_Duke_of_York
Iziaslav_I_of_Kiev	isMarriedTo	Casimir_I_the_Restorer
Ptolemy_VIII_Physcon	hasChild	Ptolemy_IX_Lathyros
Rishi_Kapoor	isMarriedTo	Neetu_Singh
Elizabeth_II	isMarriedTo	Prince_Philip,_Duke_of_Edinburgh
Randhir_Kapoor	isMarriedTo	Babita
Albert_VII,_Archduke_of_Austria	hasChild	Philip_IV_of_Spain
Saint_Louis_IX_of_France	hasChild	Philip_III_of_France
Tony_Curtis	hasChild	Jamie_Lee_Curtis
Nicholas_I_of_Russia	hasChild	Grand_Duke_Michael_Nikolaevich_of_Russia
Yolande_of_Aragon	hasChild	Margaret_of_Savoy,_Duchess_of_Anjou
William_Godwin	hasChild	Mary_Shelley
Salomea_of_Berg	hasChild	Mieszko_III_the_Old
Franklin_D._Roosevelt	hasChild	Franklin_Delano_Roosevelt,_Jr.
Sargent_Shriver	hasChild	Maria_Shriver
Christian_IV_of_Denmark	hasChild	Frederick_III_of_Denmark
Philip_II_of_Spain	isMarriedTo	Anna_of_Austria,_Queen_of_Spain
Maria_Luisa_of_Parma	hasChild	Julie_Clary
Sigismund_III_Vasa	hasChild	Władysław_IV_Vasa
Margaret_of_Provence	isMarriedTo	Saint_Louis_IX_of_France
Sirimavo_Bandaranaike	isMarriedTo	S._W._R._D._Bandaranaike
Queen_Elizabeth_The_Queen_Mother	hasChild	Prince_Philip,_Duke_of_Edinburgh
Mariana_of_Austria	hasChild	Margaret_Theresa_of_Spain
Thierry,_Count_of_Flanders	hasChild	Philip_I,_Count_of_Flanders
Iziaslav_I_of_Kiev	hasChild	Sviatoslav_II_of_Kiev
Princess_Isabelle_of_Orléans-Braganza	hasChild	Henri_d'Orléans,_Count_of_Paris
George_W._Romney	isMarriedTo	Lenore_Romney
Bretislaus_I,_Duke_of_Bohemia	hasChild	Vratislaus_II_of_Bohemia
Carlota_Joaquina_of_Spain	hasChild	Miguel_I_of_Portugal
John_V,_Duke_of_Brittany	hasChild	Arthur_III,_Duke_of_Brittany
Francis_I_of_Austria	hasChild	Marie_Louise,_Duchess_of_Parma
Antipope_Felix_V	hasChild	Louis,_Duke_of_Savoy
Peter_II_of_Portugal	hasChild	John_V_of_Portugal
Henry_IV_of_France	hasChild	Gaston,_Duke_of_Orléans
Edward,_King_of_Portugal	hasChild	Ferdinand,_Duke_of_Viseu
John_of_England	isMarriedTo	Eleanor_of_Aquitaine
Maria_Theresa	hasChild	Maria_Carolina_of_Austria
Charlie_Chaplin	hasChild	Sydney_Chaplin_(actor)
José_Baptista_Pinheiro_de_Azevedo	hasChild	Adelino_da_Palma_Carlos
Henry_III,_Holy_Roman_Emperor	hasChild	Henry_IV,_Holy_Roman_Emperor
Frederica_of_Mecklenburg-Strelitz	isMarriedTo	Ernest_Augustus_I_of_Hanover
Elizabeth_of_Bohemia_(1292–1330)	isMarriedTo	John_of_Bohemia
Maria_Feodorovna_(Dagmar_of_Denmark)	hasChild	Grand_Duchess_Xenia_Alexandrovna_of_Russia
Amélie_of_Orléans	hasChild	Manuel_II_of_Portugal
Duchess_Helene_of_Mecklenburg-Schwerin	hasChild	Prince_Philippe,_Count_of_Paris
Infante_Juan,_Count_of_Barcelona	hasChild	Juan_Carlos_I_of_Spain
Anne_of_Austria,_Queen_of_Poland	hasChild	Constance_of_Austria
John_F._Kennedy	hasChild	Lyndon_B._Johnson
Marie_Casimire_Louise_de_La_Grange_d'Arquien	isMarriedTo	John_III_Sobieski
Louise_of_Orléans	isMarriedTo	Leopold_I_of_Belgium
Louis_VIII_of_France	isMarriedTo	Blanche_of_Castile
Sigrid_the_Haughty	isMarriedTo	Sweyn_Forkbeard
Ramon_Berenguer_IV,_Count_of_Provence	hasChild	Margaret_of_Provence
Abraham_Lincoln	isMarriedTo	Mary_Todd_Lincoln
George_V	hasChild	George_VI
Carlos_Galvão_de_Melo	hasChild	Adelino_da_Palma_Carlos
Frederika_Louisa_of_Hesse-Darmstadt	hasChild	Louise_of_Mecklenburg-Strelitz
Robert_II_of_France	isMarriedTo	Constance_of_Arles
Maria_Theresa_of_Austria-Este_(1849–1919)	hasChild	Prince_Franz_of_Bavaria
Adelaide_of_Löwenstein-Wertheim-Rosenberg	hasChild	Infanta_Marie_Anne_of_Portugal
Eleonora_Gonzaga_(1630–1686)	isMarriedTo	Ferdinand_III,_Holy_Roman_Emperor
Siim_Kallas	hasChild	Joaquín_Almunia
Saint_Margaret_of_Scotland	hasChild	Alexander_I_of_Scotland
Francis_II,_Holy_Roman_Emperor	hasChild	Marie_Louise,_Duchess_of_Parma
Wilhelmine_of_Prussia,_Queen_of_the_Netherlands	hasChild	Grand_Duchess_Anna_Pavlovna_of_Russia
Charles_Emmanuel_II,_Duke_of_Savoy	hasChild	Victor_Amadeus_II_of_Sardinia
Fernando_Lamas	isMarriedTo	Arlene_Dahl
Constantine_the_Great	hasChild	Fausta
Kamehameha_I	isMarriedTo	Keōpūolani
Teresa_Cristina_of_the_Two_Sicilies	hasChild	Isabel,_Princess_Imperial_of_Brazil
John_VI_of_Portugal	hasChild	Pedro_I_of_Brazil
Catherine_de'_Medici	hasChild	Margaret_of_Valois
Matilda_II,_Countess_of_Boulogne	isMarriedTo	Philip_I,_Count_of_Boulogne
Otto_I,_Count_of_Savoy	hasChild	Peter_I,_Count_of_Savoy
Lyndon_B._Johnson	hasChild	Richard_Nixon
Matilda_of_Flanders	isMarriedTo	William_the_Conqueror
Prince_Philip,_Duke_of_Edinburgh	hasChild	Anne,_Princess_Royal
Sweyn_I_of_Denmark	hasChild	Olaf_II_of_Norway
Catherine_Jagiellon	hasChild	Sigismund_III_Vasa
Elisabeth_of_Bavaria,_Queen_of_Belgium	hasChild	Marie_José_of_Belgium
Joachim_Murat	isMarriedTo	Caroline_Bonaparte
Frederick_II_Eugene,_Duke_of_Württemberg	hasChild	Duke_Alexander_of_Württemberg_(1771–1833)
Salim_Khan	hasChild	Sohail_Khan
Louise_Marie_Thérèse_d'Artois	isMarriedTo	Charles_III,_Duke_of_Parma
Isabella_of_Castile	hasChild	Maria_of_Aragon,_Queen_of_Portugal
Philip_of_Swabia	hasChild	Elisabeth_of_Swabia
Princess_Antoinette_of_Brunswick-Wolfenbüttel	hasChild	Elisabeth_Christine_of_Brunswick-Wolfenbüttel-Bevern
Alfonso_VIII_of_Castile	hasChild	Blanche_of_Castile
Ferdinand_II_of_Aragon	hasChild	Crown_of_Aragon
Beatrice_of_Savoy	hasChild	Beatrice_of_Provence
Keōpūolani	hasChild	Kamehameha_II
Charles_III_of_Naples	isMarriedTo	Margaret,_Countess_of_Anjou
Isabella_of_Valois	hasChild	Henry_IV_of_England
Joan_Beaufort,_Countess_of_Westmorland	hasChild	Cecily_Neville,_Duchess_of_York
Stephen_Gyllenhaal	hasChild	Maggie_Gyllenhaal
Pedro_I_of_Brazil	isMarriedTo	Maria_Leopoldina_of_Austria
Bill_Clinton	hasChild	Chelsea_Clinton
Maria_of_Aragon,_Queen_of_Portugal	isMarriedTo	Manuel_I_of_Portugal
Eva_Perón	isMarriedTo	Juan_Perón
Joan_of_France,_Duchess_of_Berry	isMarriedTo	Louis_XII_of_France
Adolf_Frederick_of_Sweden	isMarriedTo	Louisa_Ulrika_of_Prussia
Mary_of_Teck	hasChild	Edward_VIII
Leopold_I,_Holy_Roman_Emperor	hasChild	Maria_Anna_of_Austria
Albert_II_of_Germany	isMarriedTo	Elizabeth_of_Luxembourg
Isabelle_of_Hainaut	hasChild	Louis_VIII_of_France
Maria_Leopoldina_of_Austria	hasChild	Maximilian_de_Beauharnais,_3rd_Duke_of_Leuchtenberg
Catherine_of_Medici	isMarriedTo	Henry_II_of_France
Charles_III,_Duke_of_Lorraine	isMarriedTo	Claude_of_Valois
Albert,_Prince_Consort	hasChild	Victoria,_Princess_Royal
Henry_III,_Holy_Roman_Emperor	isMarriedTo	Agnes_of_Poitou
Maria_Theresa_of_Austria	hasChild	Archduchess_Maria_Amalia_of_Austria
Franz_Joseph_I_of_Austria	hasChild	Charles_I_of_Austria
John_of_Bohemia	hasChild	Bonne_of_Bohemia
Maria_Anna_of_Bavaria_(1551–1608)	isMarriedTo	Charles_II,_Archduke_of_Austria
Louis_XIV_of_France	hasChild	Louis,_Grand_Dauphin
Paul_of_Greece	hasChild	Queen_Sofía_of_Spain
Jeanne_d'Albret	isMarriedTo	William,_Duke_of_Jülich-Cleves-Berg
Elisabetta_Farnese	isMarriedTo	Philip_V_of_Spain
Gena_Rowlands	hasChild	Nick_Cassavetes
Joanna,_Duchess_of_Brabant	hasChild	Anthony,_Duke_of_Brabant
Frederick_I_of_Prussia	isMarriedTo	Sophia_Charlotte_of_Hanover
Prince_Felix_of_Bourbon-Parma	isMarriedTo	Charlotte,_Grand_Duchess_of_Luxembourg
George_Washington	isMarriedTo	Martha_Washington
Maria_Luisa_of_Savoy	hasChild	Elisabetta_Farnese
Marie_de'_Medici	hasChild	Elisabeth_of_France_(1602–1644)
Ján_Figeľ	hasChild	Günter_Verheugen
Elizabeth_of_Carinthia,_Queen_of_Germany	isMarriedTo	Albert_I_of_Germany
Ferdinand_III_of_Castile	isMarriedTo	Elisabeth_of_Swabia
Eleonor_Magdalene_of_Neuburg	hasChild	Maria_Anna_of_Austria
Leopold_I_of_Belgium	isMarriedTo	Louise_of_Orléans
Jobst_of_Moravia	hasChild	Wenceslaus_IV_of_Bohemia
Casimir_IV_Jagiellon	isMarriedTo	Elisabeth_of_Habsburg_(1436–1505)
Germaine_of_Foix	isMarriedTo	Ferdinand_II_of_Aragon
Elizabeth_II	hasChild	Prince_Edward,_Earl_of_Wessex
Bonne_of_Bohemia	hasChild	John,_Duke_of_Berry
Margaret_III,_Countess_of_Flanders	isMarriedTo	Philip_the_Bold
Savang_Vadhana	hasChild	Mahidol_Adulyadej
Margaret_of_Provence	hasChild	Agnes_of_France,_Duchess_of_Burgundy
Augusta_of_Saxe-Weimar-Eisenach	hasChild	Victoria,_Princess_Royal
Edward_IV_of_England	hasChild	Elizabeth_of_York
Anne_of_Brittany	isMarriedTo	Louis_XII_of_France
Boris_III_of_Bulgaria	isMarriedTo	Giovanna_of_Italy
Albert_II_of_Belgium	hasChild	Princess_Astrid_of_Belgium,_Archduchess_of_Austria-Este
Olli_Rehn	hasChild	Günter_Verheugen
Ferdinand,_Duke_of_Breisgau	hasChild	Maria_Theresa_of_Austria-Este,_Queen_of_Sardinia
Leopold_II,_Holy_Roman_Emperor	hasChild	Archduke_Charles,_Duke_of_Teschen
John_II_of_France	hasChild	John,_Duke_of_Berry
Henry_VIII_of_England	isMarriedTo	Jane_Seymour
Caroline_of_Baden	hasChild	Princess_Ludovika_of_Bavaria
Margaret_of_Austria,_Queen_of_Bohemia	hasChild	Kunigunda_of_Halych
Peter_I,_Duke_of_Bourbon	isMarriedTo	Isabella_of_Valois
Baldwin_V,_Count_of_Hainaut	isMarriedTo	Margaret_I,_Countess_of_Flanders
Sirikit	isMarriedTo	Bhumibol_Adulyadej
Danielle_Mitterrand	hasChild	Bernadette_Chirac
Queen_Elizabeth_The_Queen_Mother	hasChild	Elizabeth_II
John_the_Fearless	hasChild	Philip_the_Good
Oscar_II_of_Sweden	isMarriedTo	Sophia_of_Nassau
John,_King_of_England	hasChild	Isabella_of_England
Isabella_of_France	hasChild	Philippa_of_Hainault
William_II_of_the_Netherlands	isMarriedTo	Anna_Pavlovna_of_Russia
François_Hollande	hasChild	Martine_Aubry
Salomea_of_Berg	hasChild	Bolesław_IV_the_Curly
Francisco_da_Costa_Gomes	isMarriedTo	Carlos_Galvão_de_Melo
Elisabeth_Christine_of_Brunswick-Wolfenbüttel	hasChild	Maria_Luisa_of_Spain
Joan_Bennett_Kennedy	hasChild	Patrick_J._Kennedy
Jada_Pinkett_Smith	hasChild	Jaden_Smith
Margaret_of_Geneva	hasChild	Beatrice_of_Savoy
Elizabeth_of_York	hasChild	Margaret_Tudor
Christian_IX_of_Denmark	hasChild	Alexandra_of_Denmark
Mary_of_Hungary,_Queen_of_Naples	hasChild	Blanche_of_Anjou
Ferdinand_III,_Holy_Roman_Emperor	isMarriedTo	Maria_Anna_of_Spain
Casimir_IV_Jagiellon	hasChild	John_I_Albert
Julia_the_Elder	hasChild	Agrippina_the_Elder
William_V,_Duke_of_Aquitaine	hasChild	Agnes_of_Poitou
Ferdinand_I_of_Naples	hasChild	Beatrice_of_Naples
Robert_Walker_(actor)	hasChild	Robert_Walker,_Jr.
Isabella_of_Angoulême	hasChild	Richard,_1st_Earl_of_Cornwall
Jacques_Chirac	hasChild	Raymond_Barre
Mary_Todd_Lincoln	hasChild	Robert_Todd_Lincoln
Marie_Curie	hasChild	Ève_Curie
Frederica_of_Hanover	isMarriedTo	Paul_of_Greece
Eleanor_of_Provence	hasChild	Eleanor_of_Castile
Barbara_Bush	isMarriedTo	George_H._W._Bush
Elisabeth_of_Habsburg_(1436–1505)	hasChild	Alexander_Jagiellon
Paul_I_of_Russia	hasChild	Grand_Duchess_Anna_Pavlovna_of_Russia
Maximilian_II,_Holy_Roman_Emperor	isMarriedTo	Maria_of_Austria,_Holy_Roman_Empress
Lalla_Latifa	hasChild	Mohammed_VI_of_Morocco
Wilhelm_II,_German_Emperor	isMarriedTo	Augusta_Victoria_of_Schleswig-Holstein
Maria_Leopoldina_of_Austria	isMarriedTo	Pedro_I_of_Brazil
Princess_Joséphine_Charlotte_of_Belgium	isMarriedTo	Jean,_Grand_Duke_of_Luxembourg
John,_King_of_Denmark	hasChild	Christian_II_of_Denmark
Nicholas_I_of_Russia	hasChild	Grand_Duke_Konstantin_Nikolayevich_of_Russia
Duchess_Maria_Anna_Victoria_of_Bavaria	isMarriedTo	Louis,_Grand_Dauphin
Maria_Theresa	hasChild	Ferdinand,_Duke_of_Breisgau
Beatrice_I,_Countess_of_Burgundy	hasChild	Otto_I,_Count_of_Burgundy
Yaroslav_the_Wise	hasChild	Anne_of_Kiev
Josephine_of_Leuchtenberg	hasChild	Oscar_II_of_Sweden
Eleanor_of_Aragon,_Queen_of_Portugal	hasChild	Isabella_of_Coimbra
Wilhelm_II_of_Germany	hasChild	Friedrich_Ebert
Maria_Amalia_of_Saxony	isMarriedTo	Charles_III_of_Spain
Eleanor_of_England,_Queen_of_Castile	hasChild	Blanche_of_Castile
Elizabeth_of_Poland,_Queen_of_Hungary	isMarriedTo	Charles_I_of_Hungary
Keōpūolani	isMarriedTo	Kamehameha_I
Victor_Emmanuel_II_of_Savoy	hasChild	Maria_Pia_of_Savoy
Sophia_Jagiellon,_Margravine_of_Brandenburg-Ansbach	hasChild	George,_Margrave_of_Brandenburg-Ansbach
Philip_of_Swabia	hasChild	Kunigunde_of_Hohenstaufen
Cleopatra	hasChild	Cleopatra_Selene_II
Anne_of_Kiev	hasChild	Bertha_of_Holland
Salomea_of_Berg	hasChild	Richeza_of_Poland,_Queen_of_Sweden
Ferdinand_II,_Holy_Roman_Emperor	isMarriedTo	Maria_Anna_of_Bavaria_(1574–1616)
Charles_II,_Grand_Duke_of_Mecklenburg-Strelitz	hasChild	Louise_of_Mecklenburg-Strelitz
Maria_Luisa_of_Spain	hasChild	Archduke_Rainer_Joseph_of_Austria
Peter_III_of_Portugal	isMarriedTo	Maria_I_of_Portugal
Charles_VII,_Holy_Roman_Emperor	hasChild	Francis_I,_Holy_Roman_Emperor
Gertrude_of_Hohenburg	hasChild	Agnes_of_Burgundy,_Duchess_of_Aquitaine
Blanche_of_Castile	hasChild	Margaret_of_Provence
John_Cassavetes	isMarriedTo	Gena_Rowlands
Ferdinand_III_of_Castile	hasChild	Eleanor_of_Castile
Christine_Marie_of_France	hasChild	Princess_Henriette_Adelaide_of_Savoy
William_the_Conqueror	hasChild	Robert_Curthose
Margaret_of_Austria,_Queen_of_Spain	hasChild	Maria_Anna_of_Spain
John_II,_Duke_of_Saxe-Weimar	hasChild	William,_Duke_of_Saxe-Weimar
Louise_of_Sweden	hasChild	Christian_X_of_Denmark
Prince_Claus_of_the_Netherlands	hasChild	Willem-Alexander_of_the_Netherlands
Henry_IV_of_France	hasChild	Elisabeth_of_France_(1602–1644)
Margo_(actress)	isMarriedTo	Eddie_Albert
Friedrich_Wilhelm,_Duke_of_Schleswig-Holstein-Sonderburg-Glücksburg	hasChild	Christian_IX_of_Denmark
Hema_Malini	hasChild	Esha_Deol
Sigismund,_Holy_Roman_Emperor	hasChild	Jobst_of_Moravia
Elizabeth_II	hasChild	Anne,_Princess_Royal
Janet_Leigh	hasChild	Jamie_Lee_Curtis
Princess_Märtha_of_Sweden	hasChild	Princess_Astrid,_Mrs._Ferner
Isabella_of_Angoulême	isMarriedTo	John,_King_of_England
Mary_of_Guise	isMarriedTo	James_V_of_Scotland
Marie_Curie	hasChild	Irène_Joliot-Curie
James_II_of_Aragon	isMarriedTo	Blanche_of_Anjou
Charles,_Count_of_Valois	hasChild	Philip_VI_of_France
Marie_Louise,_Duchess_of_Parma	isMarriedTo	Napoleon
Pat_Nixon	hasChild	Betty_Ford
Princess_Marie_of_Orléans_(1865–1909)	isMarriedTo	Prince_Valdemar_of_Denmark
Thomas,_Count_of_Savoy	isMarriedTo	Margaret_of_Geneva
Peter_III_of_Russia	isMarriedTo	Catherine_the_Great
Saint_Margaret_of_Scotland	hasChild	David_I_of_Scotland
Francis,_Duke_of_Cádiz	hasChild	Maria_Vittoria_dal_Pozzo
Princess_Augusta_of_Bavaria	hasChild	Maximilian_de_Beauharnais,_3rd_Duke_of_Leuchtenberg
Gertrude_of_Hohenburg	isMarriedTo	Rudolf_I_of_Germany
Francis,_Duke_of_Teck	hasChild	Mary_of_Teck
Dharmendra	isMarriedTo	Hema_Malini
Princess_Louise_of_Prussia	isMarriedTo	Frederick_I,_Grand_Duke_of_Baden
Charles_III_of_Spain	hasChild	Maria_Luisa_of_Spain
Agnes_of_France,_Duchess_of_Burgundy	hasChild	Joan_the_Lame
Elizabeth_of_Carinthia,_Queen_of_Germany	hasChild	Margaret_of_Brabant
Oscar_II_of_Sweden	hasChild	Prince_Carl,_Duke_of_Västergötland
Alfonso_XIII_of_Spain	hasChild	Infante_Juan,_Count_of_Barcelona
Joseph_P._Kennedy,_Sr.	hasChild	Robert_F._Kennedy
Princess_Maria_Anna_of_Anhalt-Dessau	hasChild	Prince_Friedrich_Leopold_of_Prussia
Louise_Élisabeth_d'Orléans	isMarriedTo	Louis_I_of_Spain
Dwight_D._Eisenhower	hasChild	John_F._Kennedy
Louisa_Ulrika_of_Prussia	hasChild	Gustav_III_of_Sweden
Astrid_of_Sweden	hasChild	Queen_Mathilde_of_Belgium
George_V_of_the_United_Kingdom	hasChild	Prince_Henry,_Duke_of_Gloucester
Margaret_of_Provence	isMarriedTo	Louis_IX_of_France
George_II_of_Great_Britain	hasChild	Princess_Amelia_of_Great_Britain
Carlos_Galvão_de_Melo	isMarriedTo	José_Baptista_Pinheiro_de_Azevedo
Charles_IV_of_Spain	hasChild	Carlota_Joaquina_of_Spain
Edward_I_of_England	isMarriedTo	Eleanor_of_Castile
Maria_Beatrice_of_Savoy	hasChild	Archduke_Ferdinand_Karl_Viktor_of_Austria-Este
Henrietta_Maria_of_France	hasChild	James_II_of_England
Louise_of_Sweden	isMarriedTo	Frederick_VIII_of_Denmark
Princess_Antoinette_of_Brunswick-Wolfenbüttel	isMarriedTo	Ferdinand_Albert_II,_Duke_of_Brunswick-Wolfenbüttel
Barbara_Turner_(actress)	hasChild	Jennifer_Jason_Leigh
Maria_Theresa_of_Austria-Este_(1849–1919)	isMarriedTo	Ludwig_III_of_Bavaria
John_D._Rockefeller,_Jr.	hasChild	Laurance_Rockefeller
Ulrika_Eleonora,_Queen_of_Sweden	hasChild	Frederick_I_of_Sweden
Kunigunda_of_Halych	hasChild	Wenceslaus_II_of_Bohemia
Chulalongkorn	isMarriedTo	Saovabha_Phongsri
Philip_I_of_France	hasChild	Louis_VI_of_France
Mary_Wollstonecraft	hasChild	Mary_Shelley
Victor_Emmanuel_III_of_Italy	hasChild	Giovanna_of_Italy
Philip,_Duke_of_Parma	isMarriedTo	Louise_Élisabeth_of_France
Frederick_II_Eugene,_Duke_of_Württemberg	isMarriedTo	Margravine_Friederike_of_Brandenburg-Schwedt
Tyrone_Power	hasChild	Romina_Power
Cecily_Neville,_Duchess_of_York	hasChild	Edward_IV_of_England
Louise_of_Mecklenburg-Strelitz	isMarriedTo	Frederick_William_III_of_Prussia
Caroline_of_Ansbach	hasChild	Princess_Amelia_of_Great_Britain
Judy_Garland	hasChild	Liza_Minnelli
Marie_of_Romania	hasChild	Carol_II_of_Romania
Louise_of_Hesse-Kassel	hasChild	Maria_Feodorovna_(Dagmar_of_Denmark)
Isabella_of_Clermont	hasChild	Alfonso_II_of_Naples
Phoebe_Ephron	hasChild	Nora_Ephron
Pierre_Curie	isMarriedTo	Marie_Curie
Afonso_I_of_Portugal	isMarriedTo	Odo_III,_Duke_of_Burgundy
Ferdinand_I_of_the_Two_Sicilies	hasChild	Francis_I_of_the_Two_Sicilies
Augustus	hasChild	Tiberius
Colleen_Dewhurst	hasChild	Campbell_Scott
Betty_Ford	hasChild	Rosalynn_Carter
Augusta_Victoria_of_Schleswig-Holstein	hasChild	Prince_August_Wilhelm_of_Prussia
Anne_of_Cyprus	hasChild	Philip_II,_Duke_of_Savoy
Maria_I_of_Portugal	hasChild	Infanta_Maria_Ana_Vitória_of_Portugal
Albert_VII,_Archduke_of_Austria	hasChild	Isabella_Clara_Eugenia
John_of_Lancaster,_1st_Duke_of_Bedford	hasChild	Henry_VI_of_England
fr/Silvano_Ribeiro	isMarriedTo	fr/Carlos_Fabião
Maria_Anna_of_Bavaria_(1551–1608)	hasChild	Anne_of_Austria,_Queen_of_Poland
Letizia_Ramolino	isMarriedTo	Carlo_Buonaparte
Jaya_Bachchan	hasChild	Abhishek_Bachchan
Carlota_Joaquina_of_Spain	hasChild	Maria_Leopoldina_of_Austria
Charles_I_of_England	isMarriedTo	Henrietta_Maria_of_France
Yaroslav_the_Wise	hasChild	Vsevolod_I_of_Kiev
Sidney_Poitier	hasChild	Sydney_Tamiia_Poitier
Frederika_Louisa_of_Hesse-Darmstadt	hasChild	Frederick_William_III_of_Prussia
Margaret_Leijonhufvud	hasChild	Charles_IX_of_Sweden
Christina_of_Saxony	isMarriedTo	John,_King_of_Denmark
Henry_II,_Count_of_Champagne	hasChild	Alice_of_Champagne
John,_Dauphin_of_France,_Duke_of_Touraine	isMarriedTo	Jacqueline,_Countess_of_Hainaut
Maria_Francisca_of_Savoy	isMarriedTo	Peter_II_of_Portugal
Louis,_Dauphin_of_France_(1729–1765)	isMarriedTo	Princess_Maria_Josepha_of_Saxony_(1731–1767)
Carlota_Joaquina_of_Spain	isMarriedTo	John_VI_of_Portugal
Frederick_III,_German_Emperor	hasChild	Sophia_of_Prussia
Manfred,_King_of_Sicily	hasChild	Constance_of_Sicily,_Queen_of_Aragon
Saint_Louis_IX_of_France	hasChild	Agnes_of_France,_Duchess_of_Burgundy
Richard_Nixon	hasChild	Gerald_Ford
Milena_Vukotić	hasChild	Princess_Milica_of_Montenegro
Tyrone_Power	isMarriedTo	Linda_Christian
Oona_O'Neill	hasChild	Geraldine_Chaplin
John_VI,_Duke_of_Brittany	hasChild	Francis_I,_Duke_of_Brittany
Valdemar_I_of_Denmark	isMarriedTo	Sophia_of_Minsk
Philip_IV_of_Spain	hasChild	Maria_Theresa_of_Spain
Elizabeth_of_Luxembourg	hasChild	Barbara_of_Brandenburg
Henry_I_of_England	hasChild	Empress_Matilda
Victoria,_Princess_Royal	hasChild	Edward_VII_of_the_United_Kingdom
Alexandrine_of_Mecklenburg-Schwerin	hasChild	Frederick_IX_of_Denmark
Baldwin_V,_Count_of_Flanders	isMarriedTo	Adela_of_France,_Countess_of_Flanders
Hassan_II_of_Morocco	hasChild	Mohammed_VI_of_Morocco
Ibn_Saud	hasChild	Faisal_of_Saudi_Arabia
John_II,_Duke_of_Saxe-Weimar	hasChild	Ernest_I,_Duke_of_Saxe-Gotha
Stephen_of_England	hasChild	William_I,_Count_of_Boulogne
Louis_VI_of_France	hasChild	Louis_VII_of_France
Margherita_of_Savoy	hasChild	Elena_of_Montenegro
Wu_Zetian	isMarriedTo	Emperor_Taizong_of_Tang
Irene_Angelina	isMarriedTo	Philip_of_Swabia
Edward_IV_of_England	hasChild	Henry_VI_of_England
John_II_of_France	isMarriedTo	Joan_I,_Countess_of_Auvergne
John_I_of_Portugal	isMarriedTo	Philippa_of_Lancaster
Bhumibol_Adulyadej	isMarriedTo	Sirikit
Władysław_II_the_Exile	isMarriedTo	Agnes_of_Babenberg
Edward_II_of_England	hasChild	Edward_III_of_England
Louise_Élisabeth_of_France	hasChild	Maria_Luisa_of_Parma
Ferdinand_I_of_Romania	isMarriedTo	Marie_of_Romania
Archduke_Franz_Karl_of_Austria	hasChild	Franz_Joseph_I_of_Austria
Elisabeth_of_Valois	hasChild	Infanta_Catherine_Michelle_of_Spain
Juan_Perón	hasChild	Isabel_Martínez_de_Perón
Charlotte_of_Savoy	hasChild	Catherine_of_Medici
Wilhelmina_of_the_Netherlands	isMarriedTo	Duke_Henry_of_Mecklenburg-Schwerin
Augustus	hasChild	Julia_the_Elder
Princess_Maria_Josepha_of_Saxony_(1731–1767)	hasChild	Louis_XVIII_of_France
Gordon_Brown	hasChild	Alistair_Darling
John_II_of_France	hasChild	Louis_I,_Duke_of_Anjou
Henry_III,_Holy_Roman_Emperor	hasChild	Judith_of_Swabia
Princess_Ludovika_of_Bavaria	hasChild	Karl_Theodor,_Duke_in_Bavaria
Grand_Duke_Konstantin_Nikolayevich_of_Russia	hasChild	Grand_Duke_Konstantin_Konstantinovich_of_Russia
Kekūanāoa	hasChild	Kamehameha_V
Carl_XVI_Gustaf_of_Sweden	isMarriedTo	Queen_Silvia_of_Sweden
Marie_of_Champagne	hasChild	Joan,_Countess_of_Flanders
James_IV_of_Scotland	isMarriedTo	Margaret_Tudor
Edward,_King_of_Portugal	hasChild	Eleanor_of_Portugal,_Holy_Roman_Empress
Franklin_D._Roosevelt	isMarriedTo	Eleanor_Roosevelt
Jean-Louis_Borloo	hasChild	Gilles_de_Robien
Charles_II,_Archduke_of_Austria	hasChild	Margaret_of_Austria,_Queen_of_Spain
Jean-Louis_Borloo	isMarriedTo	André_Rossinot
Bolesław_III_Wrymouth	hasChild	Richeza_of_Poland,_Queen_of_Sweden
Charles,_Duke_of_Orléans	isMarriedTo	Isabella_of_Valois
Eleanor_of_Austria,_Queen_of_Poland	isMarriedTo	Charles_V,_Duke_of_Lorraine
Marie_de'_Medici	hasChild	Gaston,_Duke_of_Orléans
Elisabetta_Farnese	hasChild	Philip,_Duke_of_Parma
Benazir_Bhutto	hasChild	Ghulam_Mustafa_Jatoi
Malcolm_III_of_Scotland	hasChild	Alexander_I_of_Scotland
Charles_I_of_England	hasChild	Oliver_Cromwell
Victor_Emmanuel_III_of_Italy	isMarriedTo	Elena_of_Montenegro
Baldwin_V,_Count_of_Hainaut	hasChild	Isabelle_of_Hainaut
Matilda_of_Flanders	hasChild	Matilda_of_Scotland
Ivan_V_of_Russia	hasChild	Peter_the_Great
Bill_Clinton	isMarriedTo	Hillary_Rodham_Clinton
Margaret_of_Geneva	hasChild	Thomas,_Count_of_Flanders
Franz_Joseph_I_of_Austria	isMarriedTo	Elisabeth_of_Bavaria
Henry_IV,_Holy_Roman_Emperor	isMarriedTo	Bertha_of_Savoy
Leopold_I_of_Belgium	hasChild	Leopold_II_of_Belgium
William_I_of_Württemberg	isMarriedTo	Caroline_Augusta_of_Bavaria
Marie_Antoinette	isMarriedTo	Louis_XVI_of_France
Henry_IV,_Holy_Roman_Emperor	hasChild	Agnes_of_Germany
Margaret_of_Brabant	isMarriedTo	Henry_VII,_Holy_Roman_Emperor
Ptolemy_I_Soter	hasChild	Berenice_I_of_Egypt
Sweyn_I_of_Denmark	hasChild	Estrid_Svendsdatter
Salim_Khan	isMarriedTo	Helen_(actress)
Cherie_Blair	hasChild	Tony_Blair
Catherine_of_Medici	hasChild	Margaret_of_Valois
Maria_Alexandrovna_(Marie_of_Hesse)	hasChild	Grand_Duke_Alexei_Alexandrovich_of_Russia
Duchess_Maria_Anna_Victoria_of_Bavaria	hasChild	Philip_V_of_Spain
Ferdinand_I_of_Austria	hasChild	Franz_Joseph_I_of_Austria
John_of_England	hasChild	Henry_III_of_England
Baldwin_I_of_Constantinople	hasChild	Joan,_Countess_of_Flanders
Maria_Amalia_of_Saxony	hasChild	Maria_Carolina_of_Austria
Eleanor_of_Aquitaine	hasChild	Eleanor_of_England,_Queen_of_Castile
Louise_Marie_Thérèse_d'Artois	hasChild	Robert_I,_Duke_of_Parma
Ferdinand_I_of_Naples	hasChild	Alfonso_II_of_Naples
Rajiv_Gandhi	hasChild	Priyanka_Gandhi
Christian_X_of_Denmark	isMarriedTo	Alexandrine_of_Mecklenburg-Schwerin
James_II,_Count_of_La_Marche	hasChild	Isabella,_Duchess_of_Lorraine
Henry_III_of_England	hasChild	Edward_I_of_England
Frederika_Louisa_of_Hesse-Darmstadt	isMarriedTo	Frederick_William_II_of_Prussia
Fernando_II_of_Portugal	hasChild	Luís_I_of_Portugal
Joan,_Countess_of_Flanders	isMarriedTo	John_IV,_Duke_of_Brittany
Gunhilda_of_Denmark	hasChild	Agnes_of_Poitou
Charles_Brandon,_1st_Duke_of_Suffolk	isMarriedTo	Mary_Tudor,_Queen_of_France
John_Adams	hasChild	Thomas_Jefferson
Marie_Leszczyńska	hasChild	Louis,_Dauphin_of_France_(1729–1765)
Isabella_of_England	hasChild	Elisabeth_of_Bavaria,_Queen_of_Germany
Archduke_Charles,_Duke_of_Teschen	hasChild	Maria_Theresa_of_Austria_(1816–1867)
Germanicus	hasChild	Agrippina_the_Younger
Elizabeth_of_Bohemia_(1292–1330)	hasChild	John_Henry,_Margrave_of_Moravia
Friedrich_III_of_Germany	isMarriedTo	Victoria,_Princess_Royal
Matilda_of_Boulogne	isMarriedTo	Stephen,_King_of_England
Isabella_of_Clermont	hasChild	Eleanor_of_Naples,_Duchess_of_Ferrara
Adelaide_of_Austria	hasChild	Amadeo_I_of_Spain
Tony_Richardson	isMarriedTo	Vanessa_Redgrave
Eleanor_of_Alburquerque	hasChild	John_II_of_Aragon
Richard_II_of_England	isMarriedTo	Isabella_of_Valois
Maria_Luisa_of_Spain	hasChild	Francis_II,_Holy_Roman_Emperor
Augusta_Victoria_of_Schleswig-Holstein	hasChild	Wilhelm,_German_Crown_Prince
Leopold_II,_Grand_Duke_of_Tuscany	isMarriedTo	Princess_Maria_Antonia_of_the_Two_Sicilies
Philip_II_of_France	hasChild	Louis_VIII_of_France
Olof_Skötkonung	hasChild	Vsevolod_I_of_Kiev
Princess_Marie_Isabelle_of_Orléans	isMarriedTo	Prince_Philippe,_Count_of_Paris
Astrid_of_Sweden	hasChild	Lilian,_Princess_of_Réthy
Robert_II_of_France	isMarriedTo	Rozala_of_Italy
Victoria,_Princess_Royal	hasChild	Wilhelm_II,_German_Emperor
Agnes_of_Poitou	hasChild	Henry_IV,_Holy_Roman_Emperor
Princess_Louise_of_Orléans	isMarriedTo	Prince_Carlos_of_Bourbon-Two_Sicilies
Henrik,_Prince_Consort_of_Denmark	hasChild	Prince_Joachim_of_Denmark
Anne_Eleonore_of_Hesse-Darmstadt	hasChild	John_Frederick,_Duke_of_Brunswick-Lüneburg
John_of_Saxony	hasChild	Albert_of_Saxony
Gisela_of_Swabia	hasChild	Gunhilda_of_Denmark
Constantine_I_of_Greece	hasChild	George_II_of_Greece
Louis_XVI_of_France	hasChild	Louis_XVIII_of_France
Isabella_of_France	hasChild	Edward_III_of_England
Constantine_I_of_Greece	hasChild	Paul_of_Greece
Joan_I_of_Navarre	isMarriedTo	Philip_IV_of_France
Philip_I_of_Castile	hasChild	Isabella_of_Austria
Charles_II,_Duke_of_Parma	hasChild	Charles_III,_Duke_of_Parma
Alexander_I_of_Scotland	isMarriedTo	Henry_I_of_England
Emperor_Gaozong_of_Tang	isMarriedTo	Wu_Zetian
Philip_V_of_Spain	hasChild	Victor_Amadeus_II_of_Sardinia
Margaret_III,_Countess_of_Flanders	isMarriedTo	Philip_I,_Duke_of_Burgundy
Galeazzo_Maria_Sforza	hasChild	Bianca_Maria_Sforza
Margaret_of_Valois	hasChild	Marie_de'_Medici
Maria_of_Aragon,_Queen_of_Portugal	hasChild	Isabella_of_Portugal
Victor_Emmanuel_II_of_Savoy	hasChild	Amadeo_I_of_Spain
Margaret_of_Bavaria	hasChild	Philip_the_Good
Archduchess_Elisabeth_Franziska_of_Austria	hasChild	Archduke_Friedrich,_Duke_of_Teschen
Charles_VII_of_France	isMarriedTo	Marie_of_Anjou
Amalric_I_of_Jerusalem	hasChild	Sibylla,_Queen_of_Jerusalem
Queen_Victoria	hasChild	Princess_Alice_of_the_United_Kingdom
Neetu_Singh	isMarriedTo	Rishi_Kapoor
Eleanor_of_Portugal,_Holy_Roman_Empress	hasChild	Kunigunde_of_Austria
Louis_VII_of_France	isMarriedTo	Eleanor_of_Aquitaine
Philippa_of_Lancaster	isMarriedTo	John_I_of_Portugal
George_W._Bush	hasChild	Rick_Perry
Catherine_I_of_Russia	hasChild	Elizabeth_of_Russia
Ferdinand_III_of_Castile	hasChild	Alfonso_X_of_Castile
Miguel_I_of_Portugal	hasChild	Miguel,_Duke_of_Braganza
Joachim_Murat	hasChild	Ferdinand_I_of_the_Two_Sicilies
Amadeo_I_of_Spain	isMarriedTo	Maria_Vittoria_dal_Pozzo
Dorothea_of_Brandenburg	isMarriedTo	Christopher_of_Bavaria
Joanna_of_Castile	hasChild	Eleanor_of_Austria
Malcolm_III_of_Scotland	isMarriedTo	Saint_Margaret_of_Scotland
Hirohito	hasChild	Akihito
Ferdinand,_Duke_of_Parma	hasChild	Pauline_Bonaparte
Louise_of_Sweden	hasChild	Alexandrine_of_Mecklenburg-Schwerin
Mary_de_Bohun	hasChild	Humphrey_of_Lancaster,_1st_Duke_of_Gloucester
Renate_Künast	isMarriedTo	Jürgen_Trittin
Henry_V,_Holy_Roman_Emperor	hasChild	Conrad_III_of_Germany
Vittorio_Emanuele_III	hasChild	Umberto_II_of_Italy
John_Barrymore	hasChild	Diana_Barrymore
Oscar_I_of_Sweden	isMarriedTo	Josephine_of_Leuchtenberg
Frederika_Louisa_of_Hesse-Darmstadt	hasChild	Prince_Wilhelm_of_Prussia_(1783–1851)
Grand_Duke_Konstantin_Nikolayevich_of_Russia	isMarriedTo	Princess_Alexandra_of_Saxe-Altenburg
Leopold_II_of_Belgium	isMarriedTo	Marie_Henriette_of_Austria
Melisende,_Queen_of_Jerusalem	isMarriedTo	Fulk,_King_of_Jerusalem
Philippa_of_Lancaster	hasChild	Edward,_King_of_Portugal
Maria_Amalia_of_Austria	isMarriedTo	Charles_VII,_Holy_Roman_Emperor
Melisende,_Queen_of_Jerusalem	hasChild	Amalric_I_of_Jerusalem
Queen_Sonja_of_Norway	hasChild	Princess_Märtha_Louise_of_Norway
Salim_Khan	hasChild	Salman_Khan
Henry_I_of_England	hasChild	Stephen_of_England
George_H._W._Bush	isMarriedTo	Barbara_Bush
Prince_Valdemar_of_Denmark	hasChild	Princess_Margaret_of_Denmark
